posted_on,positive_count,negative_count,neutral_count,total_posts,total_words,total_comments
2019-01-01,23,3,37,63,8369,989
2019-01-02,35,7,48,90,12730,1150
2019-01-03,44,11,58,113,15544,1784
2019-01-04,31,3,61,95,9832,1388
2019-01-05,17,6,34,57,7617,936
2019-01-06,37,3,40,80,8913,1176
2019-01-07,34,3,30,67,7181,1005
2019-01-08,25,6,34,65,10724,1522
2019-01-09,36,6,52,94,11733,1242
2019-01-10,26,5,36,67,7080,931
2019-01-11,29,6,34,69,7085,651
2019-01-12,23,6,40,69,8089,1067
2019-01-13,25,1,29,55,5761,1196
2019-01-14,36,3,44,83,8589,1617
2019-01-15,27,4,37,68,7556,1359
2019-01-16,36,6,32,74,6875,1279
2019-01-17,22,6,43,71,8777,851
2019-01-18,23,4,37,64,7922,1343
2019-01-19,25,2,30,57,8716,1012
2019-01-20,21,4,41,66,6658,1128
2019-01-21,33,3,49,85,7292,1042
2019-01-22,30,3,35,68,9581,1401
2019-01-23,35,5,28,68,8403,1078
2019-01-24,24,5,35,64,6795,687
2019-01-25,22,5,36,63,8535,967
2019-01-26,22,4,25,51,5992,1530
2019-01-27,20,4,30,54,4120,1234
2019-01-28,17,5,42,64,7683,995
2019-01-29,23,3,32,58,10935,1597
2019-01-30,34,3,36,73,10285,1064
2019-01-31,34,1,32,67,9386,1394
2019-02-01,22,3,30,55,8019,1577
2019-02-02,22,6,32,60,9567,971
2019-02-03,17,2,20,39,10854,806
2019-02-04,19,5,30,54,6958,881
2019-02-05,28,1,29,58,9565,793
2019-02-06,19,3,40,62,7178,644
2019-02-07,23,2,49,74,7105,758
2019-02-08,33,1,41,75,8679,741
2019-02-09,26,3,32,61,6274,1096
2019-02-10,20,7,40,67,6968,1395
2019-02-11,29,3,43,75,10237,1415
2019-02-12,25,6,43,74,9176,1117
2019-02-13,36,4,57,97,15086,909
2019-02-14,32,6,38,76,8335,753
2019-02-15,12,4,32,48,6009,838
2019-02-16,16,2,31,49,4590,557
2019-02-17,23,2,19,44,4775,867
2019-02-18,19,5,36,60,6915,790
2019-02-19,17,5,31,53,5086,900
2019-02-20,28,6,36,70,5442,989
2019-02-21,24,6,34,64,7792,540
2019-02-22,24,4,39,67,7728,1361
2019-02-23,24,4,36,64,6926,867
2019-02-24,20,3,48,71,7421,978
2019-02-25,32,10,25,67,9613,1056
2019-02-26,37,5,47,89,11314,1259
2019-02-27,27,6,45,78,11331,939
2019-02-28,24,4,36,64,6681,1090
2019-03-01,26,4,32,62,7553,1124
2019-03-02,18,4,24,46,4962,744
2019-03-03,26,6,22,54,6278,792
2019-03-04,36,8,35,79,7533,1075
2019-03-05,21,3,33,57,7025,537
2019-03-06,31,3,38,72,8243,1318
2019-03-07,25,4,38,67,6280,1179
2019-03-08,21,2,36,59,7083,1090
2019-03-09,21,5,33,59,6543,868
2019-03-10,28,2,34,64,7243,1033
2019-03-11,22,5,31,58,5657,660
2019-03-12,21,8,43,72,12572,809
2019-03-13,28,3,38,69,9053,1079
2019-03-14,25,6,29,60,8774,942
2019-03-15,17,3,31,51,6312,793
2019-03-16,18,2,29,49,7814,986
2019-03-17,15,3,33,51,5393,1020
2019-03-18,26,3,34,63,9646,955
2019-03-19,23,6,43,72,8863,1419
2019-03-20,16,1,43,60,6992,755
2019-03-21,32,4,37,73,10741,1082
2019-03-22,23,4,37,64,10338,1273
2019-03-23,8,6,32,46,5612,918
2019-03-24,17,5,30,52,5727,871
2019-03-25,20,3,28,51,6357,898
2019-03-26,19,2,43,64,7103,914
2019-03-27,20,6,35,61,7100,1114
2019-03-28,27,1,26,54,5788,915
2019-03-29,21,1,35,57,8043,874
2019-03-30,16,1,24,41,6746,923
2019-03-31,24,3,37,64,4214,815
2019-04-01,35,4,41,80,13497,1158
2019-04-02,51,12,61,124,12283,1617
2019-04-03,54,9,65,128,12475,1534
2019-04-04,43,7,58,108,12656,1735
2019-04-05,32,3,40,75,8844,1503
2019-04-06,20,7,42,69,6342,1096
2019-04-07,25,4,30,59,7763,1027
2019-04-08,34,3,40,77,10732,2092
2019-04-09,35,6,42,83,7136,1274
2019-04-10,33,5,50,88,11022,1428
2019-04-11,39,5,38,82,8044,933
2019-04-12,28,2,35,65,7604,1484
2019-04-13,26,5,28,59,5751,1368
2019-04-14,13,4,35,52,7065,1167
2019-04-15,28,7,36,71,7895,1065
2019-04-16,31,6,38,75,7740,1730
2019-04-17,25,3,40,68,7394,1421
2019-04-18,31,4,46,81,9293,1299
2019-04-19,27,2,31,60,8213,1385
2019-04-20,21,2,36,59,6571,1218
2019-04-21,20,5,26,51,5685,1125
2019-04-22,22,9,23,54,5760,1631
2019-04-23,21,7,38,66,7854,1333
2019-04-24,24,4,51,79,10106,1156
2019-04-25,26,4,48,78,9288,1924
2019-04-26,25,5,36,66,7119,1016
2019-04-27,18,4,45,67,7137,1015
2019-04-28,24,3,33,60,9422,1323
2019-04-29,37,7,37,81,7690,1564
2019-04-30,21,4,36,61,5631,930
2019-05-01,26,8,31,65,6003,870
2019-05-02,27,7,41,75,8134,1518
2019-05-03,31,1,37,69,6473,1137
2019-05-04,18,6,40,64,6143,1265
2019-05-05,23,4,30,57,6107,1284
2019-05-06,29,6,31,66,6500,1321
2019-05-07,25,5,45,75,7480,1698
2019-05-08,38,9,38,85,10583,1160
2019-05-09,31,6,45,82,8786,1596
2019-05-10,47,10,51,108,11570,2126
2019-05-11,53,8,59,120,11945,2039
2019-05-12,38,2,63,103,11744,2265
2019-05-13,61,9,79,149,15345,3254
2019-05-14,56,9,70,135,12246,2034
2019-05-15,56,11,70,137,14518,3292
2019-05-16,48,9,62,119,14081,2426
2019-05-17,40,7,54,101,11223,2215
2019-05-18,36,5,35,76,9562,1804
2019-05-19,35,3,52,90,10911,2129
2019-05-20,28,5,38,71,6186,1271
2019-05-21,30,5,59,94,9528,1758
2019-05-22,42,10,51,103,13160,2026
2019-05-23,32,6,46,84,11027,2047
2019-05-24,27,2,40,69,6405,1064
2019-05-25,30,7,53,90,10146,1878
2019-05-26,37,5,45,87,9388,2392
2019-05-27,62,6,64,132,12460,1669
2019-05-28,39,8,62,109,14006,1412
2019-05-29,32,4,50,86,8880,1349
2019-05-30,41,10,57,108,14422,1825
2019-05-31,37,7,54,98,11133,1422
2019-06-01,20,8,37,65,7498,1191
2019-06-02,23,8,39,70,8758,1398
2019-06-03,34,4,44,82,8232,1169
2019-06-04,37,3,51,91,12129,1928
2019-06-05,24,7,52,83,8763,1064
2019-06-06,25,6,45,76,10033,1591
2019-06-07,25,2,48,75,7115,1371
2019-06-08,15,5,39,59,5747,825
2019-06-09,14,1,26,41,4541,959
2019-06-10,25,1,21,47,5533,1060
2019-06-11,29,4,41,74,7665,1376
2019-06-12,29,4,30,63,7841,1493
2019-06-13,26,3,32,61,6434,934
2019-06-14,39,2,46,87,8200,1449
2019-06-15,23,3,33,59,5310,912
2019-06-16,36,6,42,84,9596,1823
2019-06-17,34,5,43,82,7443,1378
2019-06-18,29,5,61,95,10377,1532
2019-06-19,38,4,31,73,13808,930
2019-06-20,42,10,61,113,11294,1612
2019-06-21,49,9,68,126,18674,1709
2019-06-22,63,12,83,158,13096,1900
2019-06-23,46,4,64,114,10676,2009
2019-06-24,50,9,55,114,10500,1744
2019-06-25,68,5,62,135,11611,2233
2019-06-26,153,19,158,330,24357,3624
2019-06-27,82,12,105,199,17292,2374
2019-06-28,53,11,76,140,15893,2078
2019-06-29,39,4,58,101,9608,1540
2019-06-30,31,7,49,87,11242,1508
2019-07-01,37,5,55,97,12692,1496
2019-07-02,36,6,67,109,12055,1941
2019-07-03,39,6,68,113,11957,1601
2019-07-04,41,7,54,102,10255,1562
2019-07-05,32,4,33,69,8847,1293
2019-07-06,28,1,36,65,6084,1661
2019-07-07,30,9,47,86,9032,2212
2019-07-08,26,6,58,90,14706,1244
2019-07-09,38,4,59,101,12062,1708
2019-07-10,59,5,76,140,14061,1861
2019-07-11,45,3,48,96,8250,1478
2019-07-12,37,8,56,101,13140,1422
2019-07-13,35,7,42,84,9689,1493
2019-07-14,41,3,38,82,10861,2195
2019-07-15,43,6,50,99,17634,1413
2019-07-16,38,6,57,101,13187,2360
2019-07-17,55,7,63,125,17646,1667
2019-07-18,33,7,56,96,10234,1668
2019-07-19,33,6,56,95,11488,1602
2019-07-20,31,2,46,79,8149,2047
2019-07-21,35,6,51,92,12556,2572
2019-07-22,40,12,47,99,8855,2161
2019-07-23,40,5,54,99,9748,1969
2019-07-24,36,4,46,86,10488,1449
2019-07-25,38,4,54,96,13058,2102
2019-07-26,30,4,46,80,9591,1592
2019-07-27,27,4,42,73,8670,1327
2019-07-28,25,3,42,70,6512,1552
2019-07-29,33,5,49,87,12040,1167
2019-07-30,45,4,53,102,13775,1850
2019-07-31,41,4,59,104,13179,2335
2019-08-01,34,3,45,82,12436,1351
2019-08-02,45,3,36,84,9998,2073
2019-08-03,33,6,39,78,8105,1542
2019-08-04,22,1,46,69,5823,1450
2019-08-05,46,5,61,112,11188,1691
2019-08-06,34,7,51,92,8896,1882
2019-08-07,27,5,50,82,10332,1908
2019-08-08,26,3,52,81,10330,1337
2019-08-09,17,4,50,71,7172,1121
2019-08-10,36,7,45,88,9640,1353
2019-08-11,33,5,35,73,11164,1604
2019-08-12,30,5,52,87,13075,1446
2019-08-13,38,5,32,75,9351,1658
2019-08-14,35,5,46,86,12929,1509
2019-08-15,18,5,44,67,7180,950
2019-08-16,31,2,36,69,6886,1074
2019-08-17,25,2,33,60,5981,1158
2019-08-18,23,10,32,65,5952,1353
2019-08-19,28,3,46,77,6493,1333
2019-08-20,38,6,60,104,13006,1393
2019-08-21,38,6,38,82,10360,1313
2019-08-22,39,3,37,79,7166,1016
2019-08-23,24,7,45,76,7966,1325
2019-08-24,23,4,46,73,8503,1378
2019-08-25,16,5,49,70,6857,1369
2019-08-26,19,3,45,67,8446,1214
2019-08-27,27,7,55,89,10113,1267
2019-08-28,32,7,47,86,12949,1309
2019-08-29,25,7,36,68,6722,881
2019-08-30,23,4,33,60,6572,1026
2019-08-31,22,4,33,59,5941,747
2019-09-01,13,6,25,44,6453,1407
2019-09-02,29,4,35,68,7414,1247
2019-09-03,29,5,36,70,7724,1119
2019-09-04,31,2,39,72,8022,1124
2019-09-05,23,5,35,63,7447,1059
2019-09-06,18,4,33,55,6235,941
2019-09-07,21,6,31,58,4518,971
2019-09-08,22,4,21,47,9787,928
2019-09-09,17,4,30,51,7281,837
2019-09-10,28,2,26,56,5706,814
2019-09-11,28,3,39,70,8445,1030
2019-09-12,23,5,31,59,6247,850
2019-09-13,22,3,36,61,8915,1233
2019-09-14,16,3,22,41,4503,477
2019-09-15,13,1,20,34,3416,538
2019-09-16,30,7,28,65,7884,816
2019-09-17,19,6,47,72,7551,1308
2019-09-18,18,2,31,51,5898,1051
2019-09-19,33,4,34,71,11954,1570
2019-09-20,19,2,35,56,6655,977
2019-09-21,16,2,34,52,5965,865
2019-09-22,22,5,32,59,7392,1177
2019-09-23,13,6,27,46,4775,690
2019-09-24,29,4,46,79,9638,1309
2019-09-25,33,5,40,78,6054,869
2019-09-26,36,9,40,85,9546,1811
2019-09-27,23,7,51,81,7853,1137
2019-09-28,15,5,20,40,3978,661
2019-09-29,25,7,26,58,8938,1377
2019-09-30,26,5,34,65,6824,933
2019-10-01,17,1,27,45,4615,1059
2019-10-02,36,2,33,71,7543,1403
2019-10-03,22,5,32,59,5061,1241
2019-10-04,29,4,26,59,7050,1011
2019-10-05,24,4,26,54,5753,1148
2019-10-06,18,2,22,42,4842,973
2019-10-07,20,3,33,56,7527,1215
2019-10-08,24,2,23,49,6743,797
2019-10-09,31,3,41,75,5973,920
2019-10-10,20,5,29,54,5797,823
2019-10-11,14,9,26,49,6958,954
2019-10-12,21,2,27,50,5608,858
2019-10-13,26,2,17,45,4791,936
2019-10-14,30,1,25,56,5599,870
2019-10-15,28,7,35,70,9592,858
2019-10-16,26,4,39,69,7274,774
2019-10-17,21,5,25,51,6686,907
2019-10-18,24,4,38,66,7274,1487
2019-10-19,15,4,32,51,5607,887
2019-10-20,25,1,31,57,5380,955
2019-10-21,16,1,30,47,4877,617
2019-10-22,19,2,39,60,5825,901
2019-10-23,36,5,34,75,9269,2026
2019-10-24,25,5,32,62,9734,1456
2019-10-25,36,4,40,80,7861,1021
2019-10-26,25,6,38,69,5607,1237
2019-10-27,29,3,44,76,7162,1500
2019-10-28,28,6,30,64,5550,1111
2019-10-29,17,2,31,50,6393,979
2019-10-30,25,4,42,71,8347,1031
2019-10-31,37,6,28,71,8485,930
2019-11-01,29,6,37,72,10286,1382
2019-11-02,20,3,35,58,6202,996
2019-11-03,18,3,22,43,6181,874
2019-11-04,30,2,34,66,14004,1247
2019-11-05,24,2,35,61,5788,969
2019-11-06,17,1,30,48,6523,972
2019-11-07,24,0,35,59,6462,948
2019-11-08,29,3,26,58,9479,1038
2019-11-09,11,2,21,34,4395,888
2019-11-10,14,5,26,45,9900,778
2019-11-11,21,2,34,57,6379,963
2019-11-12,17,1,33,51,7100,773
2019-11-13,25,2,31,58,6755,867
2019-11-14,20,7,34,61,7088,824
2019-11-15,34,4,39,77,12037,1346
2019-11-16,16,2,15,33,4419,526
2019-11-17,14,2,27,43,5673,1048
2019-11-18,23,6,26,55,4666,1156
2019-11-19,19,2,41,62,6231,1415
2019-11-20,21,1,29,51,5738,707
2019-11-21,27,4,27,58,8121,912
2019-11-22,27,6,42,75,12181,1198
2019-11-23,21,2,25,48,8166,1061
2019-11-24,16,4,33,53,5307,641
2019-11-25,28,3,31,62,6538,1038
2019-11-26,14,2,38,54,6140,1094
2019-11-27,25,1,37,63,9059,978
2019-11-28,14,2,29,45,4439,787
2019-11-29,19,2,34,55,6890,1122
2019-11-30,13,2,33,48,4947,818
2019-12-01,18,4,37,59,5165,1152
2019-12-02,22,4,38,64,6118,803
2019-12-03,25,5,40,70,6713,1003
2019-12-04,24,6,31,61,5859,1436
2019-12-05,19,4,36,59,7844,982
2019-12-06,24,3,42,69,8670,1436
2019-12-07,10,2,26,38,6413,351
2019-12-08,20,3,20,43,4902,513
2019-12-09,21,3,31,55,6918,708
2019-12-10,21,4,31,56,6066,996
2019-12-11,17,3,35,55,6572,966
2019-12-12,20,5,26,51,5357,788
2019-12-13,13,3,24,40,4748,495
2019-12-14,19,2,26,47,5744,960
2019-12-15,23,2,24,49,9562,1410
2019-12-16,27,3,32,62,5817,937
2019-12-17,36,5,34,75,8360,1323
2019-12-18,21,5,30,56,6291,705
2019-12-19,15,4,35,54,6159,903
2019-12-20,20,3,23,46,5665,803
2019-12-21,17,2,24,43,3295,543
2019-12-22,20,1,15,36,4479,424
2019-12-23,26,2,27,55,6371,1259
2019-12-24,20,2,23,45,6590,561
2019-12-25,16,1,25,42,7211,766
2019-12-26,17,3,20,40,5075,602
2019-12-27,28,3,21,52,5732,844
2019-12-28,11,2,32,45,4020,635
2019-12-29,8,2,24,34,3025,707
2019-12-30,33,3,27,63,6284,1129
2019-12-31,19,3,25,47,7158,926
2020-01-01,21,3,27,51,5310,806
2020-01-02,18,6,36,60,7824,1004
2020-01-03,22,4,35,61,8171,1592
2020-01-04,24,4,36,64,6421,1337
2020-01-05,21,4,34,59,6011,866
2020-01-06,16,6,36,58,7637,1010
2020-01-07,24,5,26,55,4798,1105
2020-01-08,26,2,41,69,7787,1023
2020-01-09,17,3,30,50,7488,831
2020-01-10,22,3,33,58,6025,1031
2020-01-11,11,1,28,40,4988,713
2020-01-12,13,2,29,44,3801,667
2020-01-13,19,3,25,47,4462,693
2020-01-14,27,5,58,90,10568,1725
2020-01-15,22,4,41,67,4998,1300
2020-01-16,18,2,43,63,6682,768
2020-01-17,29,2,29,60,7778,1023
2020-01-18,15,5,32,52,3997,731
2020-01-19,16,6,32,54,3936,603
2020-01-20,24,3,26,53,4747,674
2020-01-21,20,6,41,67,10118,1233
2020-01-22,13,3,31,47,5093,594
2020-01-23,29,9,40,78,11284,2488
2020-01-24,30,4,56,90,16097,2383
2020-01-25,17,5,33,55,8603,1313
2020-01-26,29,4,43,76,9065,1557
2020-01-27,42,4,51,97,12136,1561
2020-01-28,28,3,38,69,7577,1037
2020-01-29,23,3,48,74,7608,1167
2020-01-30,31,5,41,77,9180,1956
2020-01-31,21,2,31,54,9933,810
2020-02-01,17,1,29,47,5037,1371
2020-02-02,19,4,38,61,5344,1049
2020-02-03,21,2,43,66,6172,999
2020-02-04,23,3,26,52,4934,623
2020-02-05,28,2,44,74,7009,1189
2020-02-06,23,6,48,77,6984,1034
2020-02-07,25,4,32,61,10972,1508
2020-02-08,11,2,33,46,4689,708
2020-02-09,31,6,44,81,8692,1241
2020-02-10,25,4,39,68,8013,1016
2020-02-11,21,5,46,72,6106,905
2020-02-12,35,4,52,91,8146,1340
2020-02-13,28,4,36,68,9593,1751
2020-02-14,29,6,42,77,9541,1125
2020-02-15,23,4,52,79,9614,1165
2020-02-16,24,7,63,94,10741,2241
2020-02-17,32,4,50,86,11436,1820
2020-02-18,37,2,44,83,8572,1280
2020-02-19,39,5,36,80,12008,1268
2020-02-20,29,6,41,76,7720,1381
2020-02-21,22,5,40,67,7801,1515
2020-02-22,26,3,34,63,8303,1518
2020-02-23,22,2,38,62,8036,920
2020-02-24,20,2,42,64,7507,998
2020-02-25,29,4,35,68,7605,1210
2020-02-26,33,7,53,93,8603,1089
2020-02-27,21,7,34,62,5464,559
2020-02-28,23,9,43,75,7570,1432
2020-02-29,16,3,34,53,4822,869
2020-03-01,15,6,34,55,5776,1190
2020-03-02,24,4,47,75,6769,1141
2020-03-03,25,4,36,65,6095,766
2020-03-04,19,5,42,66,7403,936
2020-03-05,20,4,37,61,3956,1197
2020-03-06,19,2,28,49,5051,539
2020-03-07,5,3,33,41,4554,1047
2020-03-08,14,2,27,43,5576,1599
2020-03-09,24,13,39,76,6275,1209
2020-03-10,22,4,34,60,5187,660
2020-03-11,17,6,35,58,5073,1193
2020-03-12,75,12,72,159,12340,2311
2020-03-13,73,28,109,210,15426,2139
2020-03-14,30,4,45,79,7326,1761
2020-03-15,30,5,57,92,11062,1329
2020-03-16,47,16,67,130,12695,1755
2020-03-17,37,6,43,86,8509,1163
2020-03-18,34,12,47,93,10633,1110
2020-03-19,50,9,50,109,9769,1232
2020-03-20,43,6,35,84,8071,964
2020-03-21,27,4,43,74,6178,1371
2020-03-22,21,5,42,68,5419,1039
2020-03-23,32,2,39,73,9273,1000
2020-03-24,28,4,47,79,7272,783
2020-03-25,33,4,44,81,8161,792
2020-03-26,17,3,35,55,10112,1307
2020-03-27,17,6,35,58,4977,805
2020-03-28,20,4,42,66,5801,1048
2020-03-29,17,4,24,45,2933,602
2020-03-30,25,3,41,69,6582,1005
2020-03-31,26,5,34,65,7199,759
2020-04-01,21,3,43,67,6535,642
2020-04-02,20,5,35,60,6040,896
2020-04-03,23,5,44,72,5858,827
2020-04-04,28,1,36,65,5964,1075
2020-04-05,17,3,35,55,6707,664
2020-04-06,24,4,26,54,5005,1014
2020-04-07,19,4,44,67,6317,1056
2020-04-08,20,1,35,56,6006,1298
2020-04-09,22,2,50,74,6667,797
2020-04-10,40,7,42,89,12808,1437
2020-04-11,29,6,35,70,6274,970
2020-04-12,20,2,29,51,4554,742
2020-04-13,20,2,67,89,10053,1493
2020-04-14,37,7,57,101,10274,1254
2020-04-15,35,3,38,76,10572,1670
2020-04-16,27,3,51,81,9015,1209
2020-04-17,30,4,53,87,8221,1051
2020-04-18,28,6,38,72,6114,1265
2020-04-19,28,3,63,94,11475,1382
2020-04-20,25,4,51,80,10015,813
2020-04-21,28,1,52,81,10117,1163
2020-04-22,31,4,54,89,11219,1261
2020-04-23,24,7,52,83,6957,1211
2020-04-24,27,4,56,87,13065,1257
2020-04-25,32,3,62,97,10003,1385
2020-04-26,34,5,52,91,8769,1338
2020-04-27,44,5,64,113,11509,1323
2020-04-28,41,5,70,116,12412,1052
2020-04-29,57,9,106,172,18427,7
2020-04-30,62,13,126,201,15780,16
2020-05-01,36,7,44,87,7735,1226
2020-05-02,26,6,53,85,6204,849
2020-05-03,28,4,38,70,8751,870
2020-05-04,27,3,43,73,7549,1108
2020-05-05,45,7,49,101,9996,1133
2020-05-06,34,5,50,89,10171,1325
2020-05-07,59,12,64,135,15581,3402
2020-05-08,45,11,68,124,11166,1669
2020-05-09,32,4,42,78,7682,966
2020-05-10,45,8,84,137,14966,1788
2020-05-11,66,6,93,165,14137,4468
2020-05-12,40,9,67,116,10462,1407
2020-05-13,37,6,68,111,9152,1099
2020-05-14,47,2,68,117,11423,1340
2020-05-15,47,11,78,136,12809,2148
2020-05-16,32,4,54,90,8160,1560
2020-05-17,37,8,61,106,12901,1844
2020-05-18,38,12,63,113,11750,1605
2020-05-19,47,2,64,113,10055,1883
2020-05-20,30,7,58,95,10430,1363
2020-05-21,54,10,64,128,16141,1721
2020-05-22,52,6,65,123,12863,1335
2020-05-23,29,3,46,78,9453,986
2020-05-24,24,3,45,72,6552,1083
2020-05-25,29,10,57,96,8890,1925
2020-05-26,23,3,65,91,7514,1753
2020-05-27,38,5,41,84,10083,1196
2020-05-28,38,8,39,85,8584,1085
2020-05-29,32,3,38,73,5445,954
2020-05-30,31,4,33,68,7260,897
2020-05-31,22,6,30,58,5882,978
2020-06-01,29,3,43,75,6134,890
2020-06-02,40,5,58,103,9596,1278
2020-06-03,35,2,48,85,10707,1013
2020-06-04,27,4,35,66,7426,799
2020-06-05,33,4,57,94,11987,939
2020-06-06,24,5,52,81,8360,1534
2020-06-07,29,2,30,61,5423,919
2020-06-08,34,7,42,83,8915,915
2020-06-09,26,3,46,75,7573,1013
2020-06-10,24,4,46,74,8665,1110
2020-06-11,26,5,45,76,8338,889
2020-06-12,22,4,39,65,6734,854
2020-06-13,22,1,32,55,6208,928
2020-06-14,21,6,31,58,5565,1016
2020-06-15,30,5,42,77,8048,1118
2020-06-16,18,3,46,67,7968,940
2020-06-17,31,1,43,75,11200,993
2020-06-18,26,6,51,83,7884,1241
2020-06-19,22,5,44,71,6854,852
2020-06-20,23,2,35,60,5540,965
2020-06-21,22,2,26,50,4944,699
2020-06-22,23,2,25,50,6157,618
2020-06-23,24,3,44,71,6802,657
2020-06-24,25,5,40,70,6268,948
2020-06-25,20,6,29,55,5601,953
2020-06-26,18,1,27,46,4687,648
2020-06-27,24,3,26,53,6091,1112
2020-06-28,16,2,29,47,4270,751
2020-06-29,15,4,31,50,4781,456
2020-06-30,12,2,45,59,8888,1138
2020-07-01,17,1,33,51,7072,1061
2020-07-02,19,1,24,44,4245,460
2020-07-03,24,2,38,64,5337,747
2020-07-04,16,4,35,55,4663,1103
2020-07-05,17,6,28,51,4214,759
2020-07-06,21,5,33,59,4745,726
2020-07-07,18,1,35,54,8386,784
2020-07-08,20,1,36,57,5356,715
2020-07-09,25,5,36,66,6080,1296
2020-07-10,11,5,27,43,9166,500
2020-07-11,13,4,23,40,3130,522
2020-07-12,14,2,19,35,2886,458
2020-07-13,18,3,31,52,3983,818
2020-07-14,18,0,30,48,7793,575
2020-07-15,16,3,43,62,10901,997
2020-07-16,23,3,37,63,9351,702
2020-07-17,18,1,35,54,5005,608
2020-07-18,16,1,21,38,3289,586
2020-07-19,7,1,21,29,2938,560
2020-07-20,20,2,34,56,5699,646
2020-07-21,23,4,34,61,5642,763
2020-07-22,29,2,34,65,6841,1115
2020-07-23,24,1,41,66,5948,1202
2020-07-24,22,6,42,70,11055,987
2020-07-25,20,3,39,62,6536,1346
2020-07-26,30,0,45,75,7574,1147
2020-07-27,47,4,56,107,8026,1641
2020-07-28,41,3,51,95,13804,1001
2020-07-29,36,4,48,88,14237,1118
2020-07-30,35,1,39,75,9763,1019
2020-07-31,31,7,44,82,10859,2189
2020-08-01,39,4,47,90,10012,1862
2020-08-02,35,8,65,108,9801,2005
2020-08-03,23,2,53,78,7462,1872
2020-08-04,41,1,61,103,12076,1977
2020-08-05,42,3,46,91,9725,1391
2020-08-06,35,4,83,122,13282,2743
2020-08-07,23,6,51,80,9067,1253
2020-08-08,45,3,63,111,13515,3053
2020-08-09,32,5,43,80,12899,1268
2020-08-10,38,5,51,94,9977,1732
2020-08-11,31,7,57,95,8349,1920
2020-08-12,31,2,49,82,7257,1337
2020-08-13,27,6,33,66,6443,1350
2020-08-14,28,3,46,77,9520,1391
2020-08-15,32,4,45,81,7636,1603
2020-08-16,21,2,38,61,5917,1354
2020-08-17,24,3,55,82,10761,1595
2020-08-18,41,7,62,110,9968,1838
2020-08-19,26,2,48,76,6406,1225
2020-08-20,27,2,44,73,8348,1351
2020-08-21,21,2,41,64,6576,1076
2020-08-22,27,8,37,72,8154,1599
2020-08-23,17,7,36,60,8291,1086
2020-08-24,25,2,44,71,6272,1264
2020-08-25,15,3,34,52,5776,1184
2020-08-26,21,5,35,61,5399,1037
2020-08-27,29,7,41,77,6053,992
2020-08-28,27,4,44,75,7928,1023
2020-08-29,18,4,36,58,4745,708
2020-08-30,18,1,22,41,3911,1302
2020-08-31,25,2,38,65,4806,937
2020-09-01,28,2,35,65,7509,978
2020-09-02,34,2,45,81,7070,1416
2020-09-03,36,9,44,89,10582,2197
2020-09-04,33,4,54,91,8009,1519
2020-09-05,20,7,44,71,6120,1498
2020-09-06,19,6,27,52,4927,1012
2020-09-07,20,1,41,62,7195,1046
2020-09-08,15,2,42,59,4657,898
2020-09-09,23,2,39,64,6728,1165
2020-09-10,15,0,33,48,4458,713
2020-09-11,20,4,36,60,6664,877
2020-09-12,14,2,28,44,4343,492
2020-09-13,12,2,33,47,5098,601
2020-09-14,17,2,40,59,6820,911
2020-09-15,21,2,38,61,5349,906
2020-09-16,31,3,41,75,7844,908
2020-09-17,13,3,34,50,4390,617
2020-09-18,20,5,32,57,6138,1113
2020-09-19,12,1,30,43,3770,487
2020-09-20,12,2,32,46,4711,900
2020-09-21,16,3,33,52,8569,862
2020-09-22,18,0,30,48,5499,804
2020-09-23,19,5,38,62,4802,839
2020-09-24,12,1,29,42,3979,608
2020-09-25,23,4,38,65,14006,1082
2020-09-26,14,3,27,44,4763,714
2020-09-27,8,1,36,45,4696,1174
2020-09-28,15,5,36,56,5533,1459
2020-09-29,19,3,32,54,5908,771
2020-09-30,14,3,29,46,4027,586
2020-10-01,31,2,27,60,5514,1039
2020-10-02,15,3,33,51,4514,754
2020-10-03,12,2,28,42,6242,604
2020-10-04,21,2,23,46,6480,961
2020-10-05,18,6,22,46,5747,549
2020-10-06,18,1,33,52,6014,592
2020-10-07,21,4,32,57,5037,1127
2020-10-08,19,3,29,51,3976,641
2020-10-09,22,4,33,59,5037,710
2020-10-10,19,2,23,44,4320,925
2020-10-11,18,5,19,42,3580,784
2020-10-12,23,3,40,66,6763,1004
2020-10-13,16,3,41,60,5196,824
2020-10-14,25,5,28,58,7079,1149
2020-10-15,18,4,37,59,5194,1087
2020-10-16,18,4,31,53,4666,733
2020-10-17,18,1,30,49,5217,675
2020-10-18,20,5,29,54,9381,1260
2020-10-19,26,2,47,75,7234,1323
2020-10-20,32,3,48,83,7722,1370
2020-10-21,50,10,48,108,8025,2069
2020-10-22,43,7,60,110,8111,1337
2020-10-23,39,7,47,93,7730,1328
2020-10-24,29,3,31,63,5163,1170
2020-10-25,28,4,47,79,6549,2137
2020-10-26,32,6,55,93,9672,1361
2020-10-27,43,9,61,113,10244,2289
2020-10-28,34,7,63,104,9603,1493
2020-10-29,34,7,62,103,10792,1464
2020-10-30,32,3,48,83,11094,1223
2020-10-31,33,10,51,94,7896,1581
2020-11-01,27,4,60,91,9143,1580
2020-11-02,26,4,45,75,7726,1067
2020-11-03,39,6,53,98,8488,1574
2020-11-04,38,2,52,92,9165,1330
2020-11-05,58,4,71,133,10576,3191
2020-11-06,59,5,85,149,15083,2836
2020-11-07,46,2,49,97,9665,1964
2020-11-08,28,5,44,77,8868,1117
2020-11-09,43,3,55,101,8999,1810
2020-11-10,27,4,43,74,6072,1080
2020-11-11,39,4,60,103,12698,2860
2020-11-12,59,5,62,126,14421,2285
2020-11-13,56,9,54,119,11578,2118
2020-11-14,33,4,48,85,8869,1712
2020-11-15,33,8,65,106,11477,2140
2020-11-16,56,6,58,120,13216,2541
2020-11-17,97,11,90,198,15762,3184
2020-11-18,94,16,117,227,21343,5507
2020-11-19,73,11,84,168,15179,2853
2020-11-20,81,10,80,171,16286,2559
2020-11-21,67,12,106,185,17039,3323
2020-11-22,69,14,70,153,14469,2800
2020-11-23,61,7,89,157,17167,2379
2020-11-24,90,7,102,199,18620,3550
2020-11-25,71,15,92,178,18196,3490
2020-11-26,63,9,91,163,12567,3346
2020-11-27,54,4,61,119,10358,2135
2020-11-28,47,5,62,114,11504,2460
2020-11-29,53,10,68,131,12394,2910
2020-11-30,55,9,79,143,13239,2755
2020-12-01,70,12,87,169,17319,3110
2020-12-02,46,7,77,130,14089,1941
2020-12-03,56,4,89,149,13034,2883
2020-12-04,38,7,78,123,13006,1689
2020-12-05,45,5,59,109,11802,1938
2020-12-06,40,4,58,102,9912,2441
2020-12-07,44,5,73,122,11622,2622
2020-12-08,48,9,58,115,12175,1922
2020-12-09,46,6,80,132,13503,3070
2020-12-10,45,5,57,107,9418,1707
2020-12-11,60,7,55,122,14112,2256
2020-12-12,39,9,39,87,8285,1095
2020-12-13,40,4,60,104,9554,2574
2020-12-14,53,4,56,113,10458,2077
2020-12-15,46,4,70,120,10266,2365
2020-12-16,86,12,94,192,17760,4376
2020-12-17,147,17,158,322,30694,5300
2020-12-18,101,10,106,217,21137,4052
2020-12-19,76,7,93,176,14827,3966
2020-12-20,73,9,76,158,12381,2729
2020-12-21,80,7,96,183,15658,4930
2020-12-22,64,17,114,195,26348,3901
2020-12-23,76,11,84,171,16884,3977
2020-12-24,62,10,84,156,14263,4319
2020-12-25,67,3,77,147,14532,2544
2020-12-26,112,6,114,232,21327,5610
2020-12-27,70,6,104,180,14201,2893
2020-12-28,69,8,104,181,15196,4346
2020-12-29,82,9,103,194,21432,4248
2020-12-30,108,11,141,260,22630,4457
2020-12-31,100,15,126,241,21486,4033
2021-01-01,107,8,115,230,28600,6242
2021-01-02,183,21,196,400,36938,6537
2021-01-03,190,24,222,436,40341,8933
2021-01-04,127,20,167,314,28738,5544
2021-01-05,112,12,168,292,24812,4499
2021-01-06,150,13,189,352,37788,7249
2021-01-07,224,22,259,505,51423,7619
2021-01-08,169,21,234,424,38062,5480
2021-01-09,140,16,179,335,31040,5237
2021-01-10,124,23,182,329,31983,6199
2021-01-11,192,18,200,410,41969,9125
2021-01-12,128,21,159,308,30012,5282
2021-01-13,104,21,156,281,27200,3727
2021-01-14,112,9,171,292,30427,5510
2021-01-15,105,18,130,253,24670,3452
2021-01-16,78,6,104,188,17611,4047
2021-01-17,65,15,111,191,19256,3790
2021-01-18,64,11,94,169,16407,2684
2021-01-19,71,11,112,194,18398,2871
2021-01-20,77,5,117,199,20741,2603
2021-01-21,95,9,116,220,20283,3794
2021-01-22,89,14,118,221,19079,4572
2021-01-23,57,11,82,150,15429,2712
2021-01-24,56,7,81,144,14894,2467
2021-01-25,52,11,92,155,15626,2187
2021-01-26,52,5,84,141,15381,2068
2021-01-27,47,5,101,153,13998,2579
2021-01-28,76,10,93,179,16500,4315
2021-01-29,121,13,184,318,26698,5482
2021-01-30,101,12,145,258,24972,5111
2021-01-31,90,11,140,241,25291,3937
2021-02-01,97,16,137,250,24723,4869
2021-02-02,87,9,172,268,23305,4243
2021-02-03,101,13,146,260,23333,4137
2021-02-04,98,15,166,279,26151,3471
2021-02-05,98,12,131,241,27091,3853
2021-02-06,83,11,160,254,24765,5017
2021-02-07,100,10,135,245,22523,3974
2021-02-08,185,22,194,401,33561,5717
2021-02-09,250,23,285,558,51991,6768
2021-02-10,174,21,204,399,40585,6183
2021-02-11,176,24,227,427,37793,5866
2021-02-12,145,10,191,346,36769,4529
2021-02-13,122,12,184,318,30309,5020
2021-02-14,143,26,222,391,40274,6392
2021-02-15,144,24,169,337,41977,6000
2021-02-16,145,13,180,338,37847,5990
2021-02-17,172,22,207,401,38461,6340
2021-02-18,186,23,229,438,43958,11156
2021-02-19,193,22,200,415,38448,6553
2021-02-20,193,21,251,465,45043,7467
2021-02-21,175,16,225,416,48347,6236
2021-02-22,176,27,198,401,36697,5702
2021-02-23,177,20,219,416,44383,5174
2021-02-24,159,22,178,359,36505,5352
2021-02-25,116,12,147,275,28572,4000
2021-02-26,109,15,141,265,23303,4309
2021-02-27,101,12,126,239,26976,6577
2021-02-28,132,19,137,288,28663,5319
2021-03-01,105,18,137,260,27303,4755
2021-03-02,94,11,119,224,21391,4457
2021-03-03,102,15,135,252,27284,5256
2021-03-04,85,8,129,222,21487,4979
2021-03-05,88,13,113,214,23779,3129
2021-03-06,61,10,106,177,19317,3125
2021-03-07,89,11,108,208,19167,4425
2021-03-08,94,11,141,246,25185,4759
2021-03-09,94,12,150,256,24925,4918
2021-03-10,115,16,119,250,22932,4291
2021-03-11,89,10,120,219,21048,4166
2021-03-12,96,5,128,229,26880,4696
2021-03-13,118,18,158,294,23857,4921
2021-03-14,119,14,117,250,24760,5273
2021-03-15,104,11,97,212,20005,5052
2021-03-16,118,9,150,277,24780,5075
2021-03-17,89,15,147,251,21412,5104
2021-03-18,87,10,153,250,24308,3429
2021-03-19,71,7,108,186,16815,3013
2021-03-20,62,10,80,152,14495,3406
2021-03-21,67,6,100,173,17744,3266
2021-03-22,88,9,88,185,19918,3660
2021-03-23,60,9,95,164,16469,3129
2021-03-24,96,14,125,235,23537,3948
2021-03-25,88,17,111,216,23210,5978
2021-03-26,83,9,106,198,20955,3295
2021-03-27,59,9,91,159,17973,4054
2021-03-28,68,9,94,171,17538,3572
2021-03-29,64,9,92,165,14525,3168
2021-03-30,81,14,118,213,18710,3303
2021-03-31,100,8,102,210,20917,4052
2021-04-01,75,10,118,203,22263,5214
2021-04-02,86,12,106,204,18851,2943
2021-04-03,57,8,101,166,15335,3543
2021-04-04,59,3,79,141,15519,3173
2021-04-05,81,11,93,185,17894,3673
2021-04-06,71,12,90,173,16827,3685
2021-04-07,59,8,91,158,15071,2939
2021-04-08,63,9,79,151,15406,4793
2021-04-09,57,11,92,160,18882,2902
2021-04-10,64,4,92,160,15203,3345
2021-04-11,46,7,85,138,11633,2382
2021-04-12,58,7,95,160,15877,2671
2021-04-13,109,12,135,256,24006,4694
2021-04-14,107,9,138,254,23185,3699
2021-04-15,94,13,116,223,19132,4197
2021-04-16,107,14,104,225,23529,3684
2021-04-17,78,17,155,250,24219,3123
2021-04-18,145,24,181,350,30384,7163
2021-04-19,107,18,143,268,29989,4512
2021-04-20,92,15,157,264,29912,3832
2021-04-21,98,11,151,260,28010,3979
2021-04-22,106,12,151,269,26879,5515
2021-04-23,174,26,159,359,40737,4915
2021-04-24,88,11,106,205,22482,3604
2021-04-25,78,9,124,211,22329,5312
2021-04-26,126,15,130,271,32233,4286
2021-04-27,57,14,122,193,18524,3685
2021-04-28,97,10,106,213,21262,4690
2021-04-29,73,9,114,196,19354,4221
2021-04-30,75,8,103,186,20032,3408
2021-05-01,74,9,79,162,20150,4382
2021-05-02,55,5,98,158,15708,2532
2021-05-03,68,9,95,172,18103,4294
2021-05-04,66,7,113,186,17232,3192
2021-05-05,86,8,104,198,35318,2875
2021-05-06,92,7,110,209,22211,3370
2021-05-07,67,13,101,181,18853,3052
2021-05-08,65,8,82,155,16993,3187
2021-05-09,59,13,87,159,17904,2971
2021-05-10,65,9,101,175,15641,2563
2021-05-11,77,8,81,166,16551,2946
2021-05-12,67,13,101,181,17282,3027
2021-05-13,170,22,127,319,30622,4761
2021-05-14,84,8,98,190,24952,4846
2021-05-15,78,10,80,168,19460,4005
2021-05-16,92,23,93,208,20841,4739
2021-05-17,135,15,107,257,29436,5838
2021-05-18,86,13,114,213,25117,4310
2021-05-19,302,41,252,595,49916,9982
2021-05-20,129,19,148,296,32243,6211
2021-05-21,124,21,123,268,25991,5358
2021-05-22,115,17,101,233,23355,3940
2021-05-23,131,16,110,257,26850,5671
2021-05-24,104,16,109,229,20893,3862
2021-05-25,83,11,107,201,22277,4685
2021-05-26,71,13,93,177,17284,3114
2021-05-27,78,8,97,183,20207,4518
2021-05-28,59,6,84,149,15844,4153
2021-05-29,56,11,90,157,18087,3119
2021-05-30,43,12,64,119,19141,3342
2021-05-31,56,8,70,134,14678,3183
2021-06-01,36,6,73,115,11968,2109
2021-06-02,39,4,79,122,11938,2021
2021-06-03,47,10,80,137,19250,2746
2021-06-04,53,9,69,131,12955,3434
2021-06-05,61,15,57,133,21023,4135
2021-06-06,67,9,63,139,17116,3104
2021-06-07,67,11,92,170,15692,3810
2021-06-08,103,17,120,240,23524,5141
2021-06-09,104,17,116,237,31626,4083
2021-06-10,90,9,85,184,17715,3074
2021-06-11,68,6,80,154,15277,2659
2021-06-12,66,9,64,139,16020,2348
2021-06-13,61,5,70,136,15254,3212
2021-06-14,64,5,74,143,14282,2406
2021-06-15,47,6,59,112,10263,2085
2021-06-16,51,9,72,132,14836,2523
2021-06-17,54,6,74,134,13287,4668
2021-06-18,42,3,63,108,14155,2058
2021-06-19,36,5,54,95,9847,2654
2021-06-20,44,6,44,94,10500,2740
2021-06-21,63,16,109,188,18817,3313
2021-06-22,106,16,104,226,34840,4303
2021-06-23,44,5,82,131,15176,2260
2021-06-24,43,6,77,126,16009,2384
2021-06-25,63,6,64,133,16159,2787
2021-06-26,42,6,65,113,13089,2708
2021-06-27,47,5,56,108,14573,2692
2021-06-28,56,8,53,117,12240,3147
2021-06-29,46,6,64,116,11783,2760
2021-06-30,59,7,51,117,15109,3973
2021-07-01,50,9,53,112,10698,4140
2021-07-02,57,6,58,121,12779,2211
2021-07-03,44,5,56,105,13647,1865
2021-07-04,40,3,49,92,9495,3056
2021-07-05,47,7,66,120,12827,2594
2021-07-06,30,5,46,81,11166,1423
2021-07-07,34,2,48,84,8425,1603
2021-07-08,37,4,63,104,15594,1820
2021-07-09,37,7,48,92,10768,1914
2021-07-10,30,8,42,80,12230,2873
2021-07-11,29,3,47,79,9178,2755
2021-07-12,29,7,42,78,10277,2031
2021-07-13,31,2,34,67,7141,1807
2021-07-14,37,10,59,106,10142,2723
2021-07-15,49,7,54,110,11683,3050
2021-07-16,40,7,45,92,9922,1668
2021-07-17,26,4,39,69,8542,1481
2021-07-18,21,3,37,61,9765,2204
2021-07-19,28,4,32,64,6826,1680
2021-07-20,42,4,55,101,13287,2928
2021-07-21,38,6,62,106,11470,2824
2021-07-22,17,3,56,76,7405,1323
2021-07-23,32,4,42,78,9162,1978
2021-07-24,29,4,45,78,8689,2472
2021-07-25,27,6,43,76,8507,2127
2021-07-26,66,7,56,129,12388,3326
2021-07-27,53,1,58,112,13160,3706
2021-07-28,48,5,67,120,14928,2426
2021-07-29,48,5,60,113,14391,2527
2021-07-30,45,5,47,97,12381,3251
2021-07-31,40,4,48,92,10607,2078
2021-08-01,48,3,55,106,11243,2954
2021-08-02,35,2,58,95,9951,2028
2021-08-03,30,4,61,95,7771,2071
2021-08-04,44,5,49,98,12624,2078
2021-08-05,42,3,56,101,9804,1789
2021-08-06,54,3,43,100,12131,4017
2021-08-07,30,6,46,82,8224,2481
2021-08-08,35,6,43,84,9696,2192
2021-08-09,55,5,63,123,12643,2687
2021-08-10,34,5,54,93,8227,2650
2021-08-11,48,3,60,111,14335,2594
2021-08-12,35,2,49,86,9319,2111
2021-08-13,48,2,41,91,14355,3070
2021-08-14,45,2,65,112,10519,4095
2021-08-15,31,4,43,78,11896,2291
2021-08-16,30,2,59,91,10434,2579
2021-08-17,35,4,41,80,8580,2367
2021-08-18,35,3,47,85,8366,2189
2021-08-19,39,7,61,107,10573,3205
2021-08-20,45,2,55,102,8943,4714
2021-08-21,35,4,47,86,7105,2862
2021-08-22,29,4,41,74,8865,2360
2021-08-23,31,4,43,78,9110,1852
2021-08-24,30,5,64,99,12066,2394
2021-08-25,28,6,56,90,8987,2183
2021-08-26,43,2,53,98,10095,1854
2021-08-27,38,5,66,109,10548,2988
2021-08-28,36,2,38,76,12577,2649
2021-08-29,26,2,47,75,8496,1881
2021-08-30,38,5,46,89,8820,2008
2021-08-31,25,2,52,79,9537,2156
2021-09-01,35,4,46,85,7528,2617
2021-09-02,38,4,51,93,8985,3132
2021-09-03,42,5,47,94,11524,5301
2021-09-04,34,2,53,89,11390,2153
2021-09-05,38,2,47,87,8012,3792
2021-09-06,59,5,63,127,14913,4780
2021-09-07,82,16,75,173,18947,4467
2021-09-08,56,6,76,138,17753,2351
2021-09-09,55,4,59,118,11695,3316
2021-09-10,38,2,64,104,12994,2120
2021-09-11,46,4,43,93,11130,3331
2021-09-12,26,4,49,79,9624,3023
2021-09-13,30,2,63,95,12172,2462
2021-09-14,43,7,60,110,11361,3770
2021-09-15,50,5,46,101,7814,3379
2021-09-16,45,2,49,96,12631,2205
2021-09-17,39,7,57,103,14718,2429
2021-09-18,20,3,49,72,11312,2276
2021-09-19,27,4,37,68,14127,3450
2021-09-20,49,4,66,119,12436,4762
2021-09-21,51,6,54,111,12036,3655
2021-09-22,37,4,40,81,9416,2498
2021-09-23,34,5,56,95,10722,2105
2021-09-24,59,10,70,139,12147,2601
2021-09-25,36,3,38,77,8906,2510
2021-09-26,24,6,28,58,6105,1707
2021-09-27,40,5,45,90,10241,2485
2021-09-28,46,6,45,97,9756,1876
2021-09-29,30,7,35,72,7335,1822
2021-09-30,28,4,50,82,8344,2611
2021-10-01,35,5,48,88,10323,2891
2021-10-02,18,2,42,62,5637,1969
2021-10-03,33,6,46,85,12711,1576
2021-10-04,34,3,40,77,8620,2971
2021-10-05,44,7,43,94,9986,3270
2021-10-06,43,3,59,105,12527,3463
2021-10-07,33,4,67,104,9671,2122
2021-10-08,46,4,49,99,12300,2221
2021-10-09,27,7,45,79,9498,2805
2021-10-10,30,1,44,75,8668,3434
2021-10-11,44,7,64,115,11913,2967
2021-10-12,39,2,57,98,9735,2781
2021-10-13,20,6,65,91,7242,2271
2021-10-14,50,4,58,112,11582,3837
2021-10-15,47,4,79,130,13709,3302
2021-10-16,39,7,73,119,11294,3112
2021-10-17,43,5,52,100,13428,3830
2021-10-18,60,8,52,120,12141,4392
2021-10-19,57,8,60,125,11324,6400
2021-10-20,64,8,73,145,16158,4201
2021-10-21,73,5,83,161,16891,3824
2021-10-22,43,4,58,105,10370,3397
2021-10-23,32,6,41,79,7307,2555
2021-10-24,35,3,43,81,10796,2971
2021-10-25,33,3,49,85,8923,2253
2021-10-26,43,8,75,126,13323,4372
2021-10-27,48,7,61,116,10976,4372
2021-10-28,41,7,71,119,15787,3343
2021-10-29,59,2,57,118,11204,4819
2021-10-30,36,2,50,88,9172,2776
2021-10-31,42,0,40,82,9681,2865
2021-11-01,41,5,77,123,13209,3913
2021-11-02,52,7,55,114,10235,3006
2021-11-03,41,3,64,108,12217,3670
2021-11-04,37,8,60,105,10786,4508
2021-11-05,38,6,47,91,10138,2957
2021-11-06,36,4,41,81,9719,2549
2021-11-07,30,6,62,98,9518,3557
2021-11-08,54,6,64,124,13595,5073
2021-11-09,74,7,79,160,16284,3862
2021-11-10,38,7,78,123,14579,4743
2021-11-11,51,4,77,132,11684,4810
2021-11-12,47,5,57,109,11821,4233
2021-11-13,37,4,64,105,11877,5002
2021-11-14,35,6,63,104,12630,4551
2021-11-15,43,6,55,104,11973,5026
2021-11-16,44,4,61,109,11039,3441
2021-11-17,35,4,54,93,11576,3676
2021-11-18,47,4,74,125,15749,5770
2021-11-19,47,4,60,111,11631,2747
2021-11-20,28,4,39,71,9624,4118
2021-11-21,40,5,34,79,10282,2797
2021-11-22,32,6,60,98,12863,2830
2021-11-23,39,5,55,99,9445,3834
2021-11-24,26,6,69,101,15656,2448
2021-11-25,50,3,60,113,11273,3424
2021-11-26,37,10,57,104,11673,3087
2021-11-27,36,3,53,92,11261,3212
2021-11-28,42,4,68,114,18115,3634
2021-11-29,40,2,59,101,10757,3161
2021-11-30,47,6,62,115,13299,5366
2021-12-01,42,4,64,110,9537,5154
2021-12-02,38,5,60,103,13344,4942
2021-12-03,28,5,53,86,10237,4648
2021-12-04,58,9,71,138,15442,5123
2021-12-05,40,6,68,114,15696,4736
2021-12-06,46,2,62,110,11470,3588
2021-12-07,54,5,59,118,12780,3002
2021-12-08,45,4,65,114,13792,4923
2021-12-09,30,3,50,83,9590,3597
2021-12-10,31,6,61,98,10357,4940
2021-12-11,29,1,52,82,8892,3852
2021-12-12,28,2,31,61,10742,2895
2021-12-13,36,6,66,108,13592,5657
2021-12-14,43,8,49,100,9637,4464
2021-12-15,33,8,56,97,9806,5084
2021-12-16,38,3,45,86,8451,4770
2021-12-17,37,3,52,92,10084,4854
2021-12-18,23,1,41,65,6180,4426
2021-12-19,30,4,45,79,10448,4548
2021-12-20,32,0,47,79,12450,4244
2021-12-21,37,4,41,82,11332,3362
2021-12-22,35,1,54,90,11926,2927
2021-12-23,36,3,39,78,10622,4739
2021-12-24,32,5,38,75,9731,6026
2021-12-25,26,4,39,69,6733,5138
2021-12-26,22,3,40,65,7437,4385
2021-12-27,44,5,41,90,10773,4556
2021-12-28,38,2,48,88,10343,4730
2021-12-29,28,5,41,74,10065,4783
2021-12-30,35,6,48,89,13272,3830
2021-12-31,38,5,28,71,7847,3824
2022-01-01,27,4,40,71,7628,7782
2022-01-02,32,2,36,70,8501,3738
2022-01-03,48,4,44,96,11417,5290
2022-01-04,26,3,54,83,9083,4849
2022-01-05,39,5,66,110,10862,6430
2022-01-06,60,12,63,135,14252,5087
2022-01-07,46,9,72,127,21512,7067
2022-01-08,44,5,54,103,11517,6702
2022-01-09,43,5,46,94,9445,6112
2022-01-10,34,4,46,84,7867,4959
2022-01-11,30,8,47,85,9155,4274
2022-01-12,39,3,55,97,11558,5904
2022-01-13,31,6,41,78,7823,2655
2022-01-14,33,3,42,78,6811,3607
2022-01-15,30,9,33,72,7307,4810
2022-01-16,26,4,36,66,7295,3766
2022-01-17,31,2,39,72,6975,3566
2022-01-18,24,2,38,64,5767,2202
2022-01-19,35,4,41,80,7414,4267
2022-01-20,36,3,41,80,12199,3630
2022-01-21,68,7,59,134,13647,6983
2022-01-22,64,13,70,147,13247,4220
2022-01-23,39,4,59,102,13503,3944
2022-01-24,52,4,49,105,11601,4119
2022-01-25,42,4,57,103,12128,4479
2022-01-26,43,4,61,108,17964,4650
2022-01-27,32,2,45,79,8714,3887
2022-01-28,31,3,48,82,8351,2954
2022-01-29,23,4,45,72,7295,3315
2022-01-30,28,3,43,74,11110,2651
2022-01-31,22,5,42,69,11696,3466
2022-02-01,38,4,54,96,9274,4758
2022-02-02,27,3,45,75,9614,2270
2022-02-03,24,6,39,69,6633,1989
2022-02-04,34,4,47,85,8126,3321
2022-02-05,21,5,41,67,9006,2015
2022-02-06,26,3,50,79,9391,3071
2022-02-07,47,2,44,93,10999,2388
2022-02-08,29,3,50,82,10612,2629
2022-02-09,24,4,44,72,5625,2210
2022-02-10,38,7,48,93,10040,2470
2022-02-11,19,1,54,74,7833,2771
2022-02-12,23,0,29,52,7107,1894
2022-02-13,28,5,35,68,6916,1997
2022-02-14,28,1,39,68,6183,1830
2022-02-15,29,5,44,78,8135,3349
2022-02-16,27,1,52,80,7819,1499
2022-02-17,27,2,48,77,9235,2153
2022-02-18,31,3,48,82,7937,1489
2022-02-19,32,2,43,77,7818,2357
2022-02-20,28,4,49,81,9859,2937
2022-02-21,28,5,51,84,9232,1660
2022-02-22,32,3,34,69,6567,1817
2022-02-23,21,0,48,69,8197,2708
2022-02-24,40,5,47,92,12812,3013
2022-02-25,28,1,29,58,6248,934
2022-02-26,20,4,28,52,5861,1478
2022-02-27,22,0,26,48,9184,1548
2022-02-28,36,2,49,87,10879,3018
2022-03-01,33,0,50,83,7447,2491
2022-03-02,31,3,45,79,9297,2359
2022-03-03,16,2,38,56,6593,1088
2022-03-04,15,4,36,55,7144,1751
2022-03-05,11,5,29,45,3933,1583
2022-03-06,17,1,43,61,7252,1702
2022-03-07,20,2,33,55,5082,2366
2022-03-08,27,3,40,70,8531,2151
2022-03-09,26,3,35,64,14379,1721
2022-03-10,26,3,43,72,7027,1465
2022-03-11,18,3,29,50,10489,1390
2022-03-12,16,1,37,54,6440,1302
2022-03-13,16,2,34,52,6141,1449
2022-03-14,24,5,33,62,7012,1566
2022-03-15,11,2,37,50,4498,1308
2022-03-16,32,1,33,66,6061,1363
2022-03-17,27,2,40,69,9949,2102
2022-03-18,20,3,32,55,7292,1297
2022-03-19,18,4,34,56,5763,1389
2022-03-20,24,1,38,63,6508,2000
2022-03-21,24,5,51,80,6854,1543
2022-03-22,26,3,36,65,9402,1200
2022-03-23,16,3,34,53,4165,1323
2022-03-24,25,2,33,60,7302,1811
2022-03-25,18,5,35,58,6320,1656
2022-03-26,22,3,29,54,6390,2170
2022-03-27,14,3,36,53,5836,1836
2022-03-28,31,2,33,66,7233,1148
2022-03-29,26,1,27,54,6421,1499
2022-03-30,20,0,36,56,4939,1285
2022-03-31,38,3,32,73,9157,1929
2022-04-01,16,0,55,71,6434,2327
2022-04-02,21,1,34,56,6878,2170
2022-04-03,19,4,42,65,7470,2515
2022-04-04,31,4,31,66,7306,1682
2022-04-05,25,5,35,65,7919,1305
2022-04-06,18,3,48,69,6812,1980
2022-04-07,22,9,48,79,8008,3078
2022-04-08,29,6,52,87,8656,2742
2022-04-09,22,3,39,64,7593,2957
2022-04-10,22,1,34,57,10762,2441
2022-04-11,24,8,42,74,8340,2212
2022-04-12,30,4,36,70,6669,2176
2022-04-13,22,2,43,67,6946,1790
2022-04-14,38,3,41,82,10712,2064
2022-04-15,25,1,34,60,9025,1858
2022-04-16,18,3,31,52,5492,2293
2022-04-17,17,4,34,55,6407,1749
2022-04-18,20,2,24,46,5725,1514
2022-04-19,27,5,26,58,5775,1753
2022-04-20,24,2,32,58,4895,2155
2022-04-21,25,1,33,59,8419,2593
2022-04-22,20,3,37,60,6297,1698
2022-04-23,15,6,20,41,5071,1345
2022-04-24,17,2,31,50,5571,1993
2022-04-25,27,1,31,59,7427,2025
2022-04-26,14,1,20,35,3898,1272
2022-04-27,13,3,39,55,6325,1307
2022-04-28,35,1,30,66,9200,1848
2022-04-29,21,1,36,58,7553,1455
2022-04-30,10,4,22,36,6428,629
2022-05-01,21,1,44,66,5779,3488
2022-05-02,23,1,32,56,6052,2703
2022-05-03,15,4,35,54,5398,1627
2022-05-04,18,7,31,56,15600,1901
2022-05-05,22,2,39,63,7502,1856
2022-05-06,20,3,30,53,5366,1429
2022-05-07,22,4,29,55,5355,1227
2022-05-08,23,5,30,58,8296,2338
2022-05-09,27,7,45,79,7592,3348
2022-05-10,32,4,42,78,5902,2052
2022-05-11,42,2,53,97,10527,3750
2022-05-12,52,9,74,135,11175,3939
2022-05-13,45,6,56,107,11914,2862
2022-05-14,31,3,36,70,6906,3466
2022-05-15,26,6,37,69,7888,2681
2022-05-16,32,7,40,79,6824,2366
2022-05-17,19,2,46,67,8732,1962
2022-05-18,22,7,44,73,7627,2039
2022-05-19,27,5,39,71,6894,2821
2022-05-20,18,5,35,58,6245,1828
2022-05-21,24,1,27,52,7533,2339
2022-05-22,22,2,32,56,4827,1383
2022-05-23,22,2,29,53,5502,2342
2022-05-24,29,2,38,69,7401,2507
2022-05-25,22,5,31,58,7451,3471
2022-05-26,23,2,36,61,6585,1185
2022-05-27,26,2,28,56,6541,1969
2022-05-28,16,2,27,45,5017,1060
2022-05-29,17,10,29,56,4735,2009
2022-05-30,13,2,19,34,2996,807
2022-05-31,17,0,30,47,3194,1253
2022-06-01,14,3,22,39,5191,1781
2022-06-02,17,3,22,42,3559,1258
2022-06-03,18,0,36,54,4622,1263
2022-06-04,20,3,23,46,4476,1439
2022-06-05,20,0,31,51,4972,1429
2022-06-06,22,2,44,68,6384,2618
2022-06-07,26,0,42,68,8185,2015
2022-06-08,14,3,28,45,4255,1349
2022-06-09,22,1,28,51,7092,1339
2022-06-10,15,6,30,51,5586,2092
2022-06-11,14,4,26,44,4605,1830
2022-06-12,15,1,18,34,3466,835
2022-06-13,68,10,61,139,15291,4656
2022-06-14,60,16,65,141,13298,3636
2022-06-15,44,12,65,121,13667,6867
2022-06-16,32,8,40,80,9340,2430
2022-06-17,36,8,43,87,9231,3420
2022-06-18,66,13,62,141,15406,5202
2022-06-19,50,16,52,118,13271,3674
2022-06-20,25,7,34,66,7168,2480
2022-06-21,30,5,42,77,8843,1951
2022-06-22,29,3,52,84,9777,2340
2022-06-23,31,5,37,73,6838,1752
2022-06-24,19,5,27,51,6958,2438
2022-06-25,19,2,23,44,4013,1295
2022-06-26,16,4,37,57,6957,2212
2022-06-27,27,3,40,70,7822,1794
2022-06-28,21,5,33,59,6640,1735
2022-06-29,17,5,31,53,5571,2522
2022-06-30,27,8,40,75,8218,3315
2022-07-01,24,5,35,64,6007,2214
2022-07-02,24,5,33,62,7612,1858
2022-07-03,15,5,31,51,5300,1506
2022-07-04,20,7,31,58,5570,1971
2022-07-05,19,4,38,61,4921,1710
2022-07-06,13,5,35,53,6092,1195
2022-07-07,24,3,31,58,7715,1767
2022-07-08,27,2,33,62,9005,2276
2022-07-09,18,1,21,40,2961,1818
2022-07-10,12,2,16,30,2932,1361
2022-07-11,19,5,18,42,3887,1309
2022-07-12,23,5,48,76,5690,2975
2022-07-13,15,1,35,51,4597,1217
2022-07-14,19,2,33,54,7505,3339
2022-07-15,20,2,34,56,6327,1458
2022-07-16,18,1,31,50,5935,1866
2022-07-17,11,1,33,45,4093,2252
2022-07-18,19,2,19,40,5273,1579
2022-07-19,17,2,36,55,5034,2263
2022-07-20,16,4,36,56,5213,966
2022-07-21,17,5,34,56,7047,1241
2022-07-22,16,1,29,46,3914,1088
2022-07-23,11,1,19,31,2747,823
2022-07-24,19,0,14,33,2819,1770
2022-07-25,23,3,25,51,4498,939
2022-07-26,15,2,35,52,7378,1450
2022-07-27,16,7,28,51,7783,1055
2022-07-28,18,1,43,62,7684,1181
2022-07-29,21,3,25,49,5238,1565
2022-07-30,20,1,31,52,5767,1046
2022-07-31,15,1,20,36,3280,1031
2022-08-01,17,2,33,52,10665,1443
2022-08-02,14,2,21,37,4057,1414
2022-08-03,19,0,28,47,4278,741
2022-08-04,16,2,30,48,5118,1296
2022-08-05,15,4,30,49,5814,1946
2022-08-06,19,0,21,40,3658,1584
2022-08-07,13,2,12,27,2160,787
2022-08-08,19,0,26,45,4997,1855
2022-08-09,13,2,23,38,3637,1346
2022-08-10,21,0,22,43,4495,1144
2022-08-11,23,5,23,51,4520,1573
2022-08-12,11,0,23,34,4886,1407
2022-08-13,9,1,22,32,2372,1764
2022-08-14,20,1,17,38,3739,1025
2022-08-15,15,2,25,42,3910,1079
2022-08-16,8,2,31,41,3561,1266
2022-08-17,16,1,29,46,3890,849
2022-08-18,17,2,28,47,4437,1563
2022-08-19,16,2,9,27,1881,1008
2022-08-20,15,1,14,30,3984,702
2022-08-21,14,1,24,39,2613,985
2022-08-22,20,1,17,38,3366,1490
2022-08-23,21,1,30,52,4512,1805
2022-08-24,13,3,19,35,3768,2486
2022-08-25,13,1,21,35,3327,1104
2022-08-26,11,3,20,34,5167,1247
2022-08-27,7,1,23,31,2500,855
2022-08-28,7,0,21,28,2238,737
2022-08-29,14,1,26,41,4924,1673
2022-08-30,13,0,24,37,3210,1203
2022-08-31,21,1,29,51,4653,1442
2022-09-01,15,1,21,37,4889,1087
2022-09-02,15,2,20,37,4162,919
2022-09-03,18,0,19,37,4287,1224
2022-09-04,9,2,15,26,2307,519
2022-09-05,15,0,16,31,2669,400
2022-09-06,12,3,19,34,4107,1520
2022-09-07,9,4,20,33,3234,1128
2022-09-08,14,3,13,30,3548,1407
2022-09-09,14,0,23,37,2642,860
2022-09-10,10,0,13,23,2402,1006
2022-09-11,18,1,15,34,5154,1190
2022-09-12,16,0,30,46,4009,1106
2022-09-13,8,0,21,29,4497,460
2022-09-14,12,3,23,38,3600,967
2022-09-15,8,3,18,29,3063,625
2022-09-16,12,3,20,35,4350,1205
2022-09-17,7,0,17,24,2133,761
2022-09-18,9,0,15,24,2512,491
2022-09-19,11,2,20,33,3836,1158
2022-09-20,17,3,17,37,5882,1207
2022-09-21,14,2,20,36,3843,947
2022-09-22,16,1,21,38,4125,801
2022-09-23,10,3,15,28,4542,834
2022-09-24,12,2,18,32,2534,599
2022-09-25,8,1,10,19,2199,1177
2022-09-26,18,0,19,37,3861,1334
2022-09-27,24,4,24,52,4052,2275
2022-09-28,17,3,14,34,3492,845
2022-09-29,10,3,18,31,2565,526
2022-09-30,16,1,30,47,6410,1231
2022-10-01,18,1,21,40,4480,999
2022-10-02,14,1,20,35,7685,1406
2022-10-03,12,1,16,29,2028,809
2022-10-04,19,2,17,38,5018,878
2022-10-05,14,0,20,34,3384,719
2022-10-06,14,1,23,38,3458,660
2022-10-07,15,5,18,38,6249,829
2022-10-08,7,0,11,18,5593,700
2022-10-09,15,2,11,28,3723,1110
2022-10-10,10,1,23,34,3228,1204
2022-10-11,18,4,22,44,4428,1383
2022-10-12,17,1,28,46,6649,738
2022-10-13,17,3,30,50,5616,942
2022-10-14,14,2,12,28,3935,827
2022-10-15,13,2,15,30,2206,950
2022-10-16,8,1,22,31,4048,931
2022-10-17,17,1,33,51,8859,1381
2022-10-18,16,1,21,38,3434,1054
2022-10-19,12,4,20,36,3454,1444
2022-10-20,13,2,18,33,4935,830
2022-10-21,9,3,27,39,4074,1049
2022-10-22,11,1,17,29,3165,727
2022-10-23,16,2,22,40,3761,903
2022-10-24,16,3,24,43,3754,1124
2022-10-25,17,1,21,39,3848,744
2022-10-26,11,1,23,35,3610,1358
2022-10-27,14,1,23,38,2672,674
2022-10-28,10,2,11,23,2720,934
2022-10-29,13,1,17,31,3132,1159
2022-10-30,7,0,14,21,2195,376
2022-10-31,7,5,24,36,3799,1224
2022-11-01,13,3,22,38,3060,1172
2022-11-02,8,2,15,25,2922,692
2022-11-03,18,0,23,41,4157,1085
2022-11-04,13,2,19,34,6046,639
2022-11-05,10,0,17,27,2743,983
2022-11-06,4,0,11,15,1658,290
2022-11-07,11,4,18,33,2844,1005
2022-11-08,21,2,24,47,4721,1339
2022-11-09,33,2,53,88,8530,2509
2022-11-10,22,6,39,67,5358,1030
2022-11-11,17,3,44,64,5920,2446
2022-11-12,22,4,28,54,4150,1224
2022-11-13,24,7,55,86,6757,3139
2022-11-14,29,5,51,85,12132,1454
2022-11-15,29,2,35,66,5495,1072
2022-11-16,22,8,46,76,8720,1805
2022-11-17,26,2,34,62,7132,964
2022-11-18,21,3,40,64,6166,1250
2022-11-19,23,3,29,55,6157,1198
2022-11-20,16,7,32,55,5364,1392
2022-11-21,23,7,37,67,7509,1887
2022-11-22,32,6,41,79,8792,1440
2022-11-23,26,2,40,68,9247,1922
2022-11-24,19,1,28,48,6180,2990
2022-11-25,23,3,25,51,5885,1690
2022-11-26,19,4,24,47,4314,2044
2022-11-27,16,1,34,51,4051,2157
2022-11-28,20,4,41,65,5195,2979
2022-11-29,36,5,53,94,11382,2832
2022-11-30,19,2,22,43,3396,919
2022-12-01,12,2,24,38,3614,1186
2022-12-02,17,6,33,56,6294,1591
2022-12-03,13,3,20,36,3846,1226
2022-12-04,19,3,15,37,4245,2221
2022-12-05,20,1,24,45,4795,973
2022-12-06,20,8,29,57,5656,1330
2022-12-07,26,1,35,62,6506,2452
2022-12-08,19,5,30,54,7429,1427
2022-12-09,16,2,27,45,5730,3759
2022-12-10,13,5,34,52,5134,1938
2022-12-11,50,4,48,102,10817,2874
2022-12-12,36,6,43,85,9156,2123
2022-12-13,30,2,45,77,7098,1207
2022-12-14,34,5,35,74,8125,1904
2022-12-15,13,5,28,46,4993,956
2022-12-16,29,4,26,59,5649,1712
2022-12-17,20,3,31,54,6454,1431
2022-12-18,27,9,15,51,5895,1525
2022-12-19,18,3,25,46,5091,1448
2022-12-20,20,4,22,46,6409,1762
2022-12-21,17,5,29,51,5928,1551
2022-12-22,16,4,16,36,3022,973
2022-12-23,19,1,26,46,3763,1400
2022-12-24,16,5,21,42,3316,1129
2022-12-25,18,2,25,45,3210,1543
2022-12-26,18,3,29,50,4490,801
2022-12-27,10,5,17,32,2662,745
2022-12-28,21,6,36,63,7155,1636
2022-12-29,20,6,24,50,5753,1212
2022-12-30,25,4,34,63,7052,1900
2022-12-31,11,1,27,39,3064,601
