posted_on,positive_count,negative_count,neutral_count,total_posts,total_words,total_stopwords,total_comments,average_word_length,mean_vader_score
2019-01-01,41,3,19,63,8369,3054,989,5.4884776530371076,0.5561015873015873
2019-01-02,48,9,33,90,12730,4843,1150,5.805391022126431,0.36119666666666667
2019-01-03,56,20,37,113,15544,5994,1784,5.870046743390927,0.2897637168141593
2019-01-04,41,10,44,95,9832,3628,1388,5.753959035940994,0.27875578947368423
2019-01-05,26,8,23,57,7617,2835,936,5.877867089015255,0.26651929824561404
2019-01-06,43,13,24,80,8913,3176,1176,5.741503707785752,0.33462125
2019-01-07,35,4,28,67,7181,2654,1005,5.677632287019823,0.4021910447761194
2019-01-08,32,17,16,65,10724,4333,1522,5.75841304118483,0.2276276923076923
2019-01-09,45,19,30,94,11733,4442,1242,5.816670607868558,0.26081702127659573
2019-01-10,35,15,17,67,7080,2548,931,5.642854412722818,0.2617179104477612
2019-01-11,36,9,24,69,7085,2775,651,5.883376785946471,0.35915797101449276
2019-01-12,38,10,21,69,8089,3162,1067,5.6516069673984966,0.3493608695652174
2019-01-13,27,8,20,55,5761,2064,1196,5.666641777695981,0.33852363636363636
2019-01-14,40,13,30,83,8589,3157,1617,6.113559997516703,0.2824265060240964
2019-01-15,34,10,24,68,7556,2789,1359,5.767243467473926,0.2835044117647059
2019-01-16,44,10,20,74,6875,2505,1279,5.732744426648128,0.41560675675675673
2019-01-17,30,12,29,71,8777,3328,851,5.788387389725597,0.22552112676056338
2019-01-18,35,9,20,64,7922,2509,1343,5.758893774846374,0.3746625
2019-01-19,26,7,24,57,8716,2807,1012,5.7086291424580855,0.2765035087719298
2019-01-20,35,6,25,66,6658,2479,1128,5.607839676435156,0.382339393939394
2019-01-21,39,11,35,85,7292,2727,1042,5.765018822129271,0.31822
2019-01-22,34,6,28,68,9581,3660,1401,5.821733020025178,0.36881470588235293
2019-01-23,28,8,32,68,8403,3183,1078,5.780786393429837,0.27143088235294116
2019-01-24,30,7,27,64,6795,2590,687,5.627284098975606,0.3216265625
2019-01-25,35,9,19,63,8535,3234,967,5.596877208646789,0.34802222222222223
2019-01-26,24,12,15,51,5992,2257,1530,5.836744108813701,0.24789607843137254
2019-01-27,34,5,15,54,4120,1511,1234,5.7192319745963465,0.468862962962963
2019-01-28,36,12,16,64,7683,2868,995,5.765157134105262,0.3551546875
2019-01-29,33,9,16,58,10935,4104,1597,5.770496378579516,0.3660603448275862
2019-01-30,44,6,23,73,10285,3995,1064,5.782892278296255,0.4419219178082192
2019-01-31,32,14,21,67,9386,3434,1394,5.82371536053598,0.29357761194029847
2019-02-01,25,11,19,55,8019,3086,1577,5.826690684222654,0.24209454545454548
2019-02-02,31,12,17,60,9567,3547,971,5.871821318899103,0.31037499999999996
2019-02-03,20,6,13,39,10854,3599,806,5.621661663206354,0.37086153846153846
2019-02-04,23,15,16,54,6958,2670,881,5.938619343569498,0.19057592592592593
2019-02-05,35,7,16,58,9565,3705,793,5.953036761189728,0.4234155172413793
2019-02-06,36,7,19,62,7178,2763,644,5.82490972394405,0.41434516129032256
2019-02-07,38,10,26,74,7105,2647,758,5.597653167834866,0.29531486486486486
2019-02-08,37,13,25,75,8679,3192,741,5.757140221977181,0.286788
2019-02-09,28,9,24,61,6274,2274,1096,5.649473669836555,0.27027213114754095
2019-02-10,36,12,19,67,6968,2561,1395,8.208611165393146,0.36573731343283583
2019-02-11,41,11,23,75,10237,3875,1415,5.733364353227522,0.41135733333333335
2019-02-12,37,17,20,74,9176,3441,1117,5.945871493439132,0.2128756756756757
2019-02-13,42,24,31,97,15086,5835,909,5.711197117411442,0.17921443298969073
2019-02-14,45,14,17,76,8335,3118,753,5.746445084240379,0.3456697368421053
2019-02-15,17,13,18,48,6009,2250,838,5.95174566979344,0.10440416666666665
2019-02-16,21,13,15,49,4590,1737,557,5.741169394468922,0.19251428571428575
2019-02-17,23,4,17,44,4775,1800,867,5.7671633163776725,0.43425454545454545
2019-02-18,33,9,18,60,6915,2539,790,5.873523112858339,0.3309366666666667
2019-02-19,21,14,18,53,5086,1915,900,5.62175294500811,0.15244716981132078
2019-02-20,39,8,23,70,5442,2014,989,5.672837380709324,0.3591814285714286
2019-02-21,37,9,18,64,7792,2952,540,5.894428080862644,0.411375
2019-02-22,35,11,21,67,7728,2965,1361,5.623703285904801,0.3531074626865672
2019-02-23,36,5,23,64,6926,2303,867,5.8485299570910785,0.43943750000000004
2019-02-24,32,14,25,71,7421,2858,978,5.708966279672315,0.21652676056338027
2019-02-25,44,7,16,67,9613,3684,1056,5.7622078279082745,0.5126835820895522
2019-02-26,40,17,32,89,11314,4129,1259,5.650312002154112,0.2716258426966292
2019-02-27,43,9,26,78,11331,4440,939,5.733252744681804,0.3696371794871795
2019-02-28,34,6,24,64,6681,2451,1090,5.818756176233493,0.4078765625
2019-03-01,36,7,19,62,7553,2737,1124,5.6480528572481274,0.4004806451612903
2019-03-02,24,4,18,46,4962,1742,744,5.805591694594028,0.3922760869565217
2019-03-03,28,10,16,54,6278,2444,792,5.63816259276743,0.29319074074074075
2019-03-04,45,5,29,79,7533,2842,1075,5.67322914701647,0.47400886075949367
2019-03-05,24,12,21,57,7025,2492,537,5.679053812270555,0.1824280701754386
2019-03-06,42,7,23,72,8243,3165,1318,5.5560017502819665,0.43805694444444443
2019-03-07,39,5,23,67,6280,2295,1179,5.724050367133402,0.4404029850746269
2019-03-08,30,8,21,59,7083,2701,1090,5.742325238867713,0.3409067796610169
2019-03-09,30,5,24,59,6543,2543,868,5.605265178419651,0.3677372881355932
2019-03-10,27,11,26,64,7243,2712,1033,6.615767136838372,0.2230125
2019-03-11,26,7,25,58,5657,2158,660,5.779569011925021,0.2916
2019-03-12,40,7,25,72,12572,4809,809,5.8000035459029995,0.4071472222222222
2019-03-13,35,14,20,69,9053,3494,1079,5.782176810214932,0.275131884057971
2019-03-14,36,5,19,60,8774,3399,942,5.74660194824493,0.459135
2019-03-15,23,9,19,51,6312,2380,793,5.687286704797603,0.267578431372549
2019-03-16,23,8,18,49,7814,3255,986,5.714098648316625,0.27422857142857143
2019-03-17,26,4,21,51,5393,1961,1020,5.8143882565385505,0.3827176470588235
2019-03-18,34,9,20,63,9646,3692,955,5.82095637761083,0.33904285714285715
2019-03-19,33,13,26,72,8863,3289,1419,5.852352058859537,0.26805694444444444
2019-03-20,32,10,18,60,6992,2606,755,5.86666234092102,0.3573316666666667
2019-03-21,45,9,19,73,10741,4055,1082,5.786976028718756,0.44545205479452055
2019-03-22,34,13,17,64,10338,3901,1273,5.7462478472956855,0.31376875
2019-03-23,23,8,15,46,5612,2138,918,5.578576142208731,0.333304347826087
2019-03-24,19,16,17,52,5727,2240,871,5.595261607489352,0.07954230769230769
2019-03-25,36,6,9,51,6357,2392,898,5.675329823452143,0.5068058823529412
2019-03-26,31,11,22,64,7103,2731,914,5.705581474485018,0.2943125
2019-03-27,38,6,17,61,7100,2688,1114,5.712282167689061,0.4735606557377049
2019-03-28,36,5,13,54,5788,2237,915,5.810950809464048,0.519237037037037
2019-03-29,34,4,19,57,8043,3123,874,5.618673411860115,0.4218263157894737
2019-03-30,20,10,11,41,6746,2525,923,5.658702206996266,0.2180487804878049
2019-03-31,25,10,29,64,4214,1467,815,5.6735658802763735,0.20056718750000002
2019-04-01,42,14,24,80,13497,5040,1158,5.85866434837749,0.2927575
2019-04-02,56,19,49,124,12283,4539,1617,5.554331756364433,0.2669508064516129
2019-04-03,65,21,42,128,12475,4842,1534,5.588505924393664,0.2966890625
2019-04-04,53,11,44,108,12656,5140,1735,5.6744158775107,0.35311203703703703
2019-04-05,42,10,23,75,8844,3332,1503,5.696857664006389,0.4023
2019-04-06,35,11,23,69,6342,2220,1096,5.642835443163293,0.2793826086956522
2019-04-07,28,6,25,59,7763,2758,1027,5.552763216209178,0.3301220338983051
2019-04-08,37,11,29,77,10732,4189,2092,5.593990762378013,0.31145324675324676
2019-04-09,46,13,24,83,7136,2713,1274,6.1054462052353555,0.35328795180722894
2019-04-10,43,17,28,88,11022,4178,1428,5.947535692524101,0.2834284090909091
2019-04-11,44,11,27,82,8044,3128,933,5.753774736766554,0.3527804878048781
2019-04-12,35,10,20,65,7604,2846,1484,5.753303353597602,0.3421169230769231
2019-04-13,22,12,25,59,5751,2043,1368,5.764291039691447,0.19132542372881356
2019-04-14,21,5,26,52,7065,2704,1167,5.518971399727767,0.3023903846153846
2019-04-15,39,11,21,71,7895,3037,1065,5.716290784058523,0.3634366197183098
2019-04-16,32,17,26,75,7740,2827,1730,5.572517124938587,0.12418133333333335
2019-04-17,30,15,23,68,7394,2717,1421,5.613156982834286,0.1732705882352941
2019-04-18,42,19,20,81,9293,3598,1299,5.7783942627781775,0.23388395061728395
2019-04-19,39,5,16,60,8213,3159,1385,5.70061132864688,0.5075033333333333
2019-04-20,25,6,28,59,6571,2463,1218,5.794240185577247,0.3027033898305085
2019-04-21,28,9,14,51,5685,2147,1125,5.729074871428413,0.3501
2019-04-22,27,5,22,54,5760,2114,1631,5.778656410656127,0.3970351851851852
2019-04-23,32,9,25,66,7854,2975,1333,5.546167229681862,0.33112878787878786
2019-04-24,34,16,29,79,10106,3567,1156,5.617000547971475,0.23004810126582279
2019-04-25,39,13,26,78,9288,3580,1924,5.523823191037363,0.2806102564102564
2019-04-26,32,9,25,66,7119,2681,1016,5.669580996424937,0.312789393939394
2019-04-27,29,16,22,67,7137,2729,1015,5.4242886495670195,0.18410746268656716
2019-04-28,31,12,17,60,9422,3698,1323,5.699342618128361,0.2789683333333333
2019-04-29,45,11,25,81,7690,2851,1564,5.960638359654744,0.3936012345679012
2019-04-30,36,10,15,61,5631,2118,930,5.867740190116409,0.34716721311475407
2019-05-01,40,7,18,65,6003,2219,870,5.663121885491,0.4285953846153846
2019-05-02,36,14,25,75,8134,3104,1518,5.646131920115208,0.283008
2019-05-03,28,12,29,69,6473,2294,1137,5.61823707963949,0.23037536231884057
2019-05-04,27,13,24,64,6143,2218,1265,5.597093538604524,0.242340625
2019-05-05,26,9,22,57,6107,2334,1284,5.667406985307059,0.29714912280701755
2019-05-06,40,11,15,66,6500,2457,1321,5.565144413084644,0.38808181818181814
2019-05-07,40,13,22,75,7480,2766,1698,5.678223793747497,0.27209466666666665
2019-05-08,42,14,29,85,10583,3995,1160,5.594966427991553,0.3067541176470588
2019-05-09,39,14,29,82,8786,3277,1596,5.910540248019791,0.28633292682926825
2019-05-10,55,16,37,108,11570,4355,2126,5.716095137441323,0.3317833333333333
2019-05-11,59,14,47,120,11945,4674,2039,5.675420296849658,0.33794500000000005
2019-05-12,48,17,38,103,11744,4417,2265,5.4968790842528135,0.2938640776699029
2019-05-13,69,18,62,149,15345,5830,3254,5.546091332462527,0.29551208053691275
2019-05-14,66,19,50,135,12246,4754,2034,5.499633511920152,0.29328296296296297
2019-05-15,60,25,52,137,14518,5602,3292,5.581396676510905,0.19972919708029196
2019-05-16,62,20,37,119,14081,5177,2426,5.6730667621685,0.29904369747899157
2019-05-17,46,16,39,101,11223,4285,2215,5.563268305736205,0.25125643564356437
2019-05-18,43,12,21,76,9562,3769,1804,5.524207518538451,0.3666868421052632
2019-05-19,54,13,23,90,10911,4154,2129,5.609557604763,0.40377222222222225
2019-05-20,36,11,24,71,6186,2344,1271,5.569815424751124,0.35630704225352117
2019-05-21,49,14,31,94,9528,3591,1758,5.641576570115029,0.3439042553191489
2019-05-22,51,13,39,103,13160,5050,2026,5.772923907491759,0.3267747572815534
2019-05-23,51,14,19,84,11027,4188,2047,5.629184594545341,0.3954535714285714
2019-05-24,40,10,19,69,6405,2363,1064,5.560125628329777,0.398868115942029
2019-05-25,35,16,39,90,10146,3227,1878,5.5904377142076225,0.17148666666666668
2019-05-26,43,11,33,87,9388,3560,2392,5.557945429230505,0.3329793103448276
2019-05-27,85,10,37,132,12460,4630,1669,5.672724546993459,0.4719833333333333
2019-05-28,52,14,43,109,14006,5266,1412,5.612756672844832,0.33773394495412845
2019-05-29,43,12,31,86,8880,3449,1349,5.59427704543763,0.3117988372093023
2019-05-30,58,14,36,108,14422,5695,1825,5.649420497002361,0.3700925925925926
2019-05-31,55,21,22,98,11133,4058,1422,5.692993783870356,0.3322908163265306
2019-06-01,39,9,17,65,7498,2930,1191,5.653581061493516,0.4022184615384616
2019-06-02,41,10,19,70,8758,3571,1398,5.621922154965904,0.3911957142857143
2019-06-03,45,19,18,82,8232,3196,1169,5.71448335014363,0.28688048780487807
2019-06-04,49,21,21,91,12129,4530,1928,5.6846693400833965,0.2732
2019-06-05,46,13,24,83,8763,3420,1064,5.857146704365682,0.3412795180722892
2019-06-06,47,9,20,76,10033,3808,1591,5.574073671792044,0.40413815789473684
2019-06-07,37,9,29,75,7115,2821,1371,5.864728686796861,0.32245333333333337
2019-06-08,26,14,19,59,5747,1955,825,5.64797922813037,0.20118644067796612
2019-06-09,25,5,11,41,4541,1665,959,5.823687730053117,0.35612195121951223
2019-06-10,28,8,11,47,5533,2050,1060,5.786309480548452,0.3899170212765958
2019-06-11,36,10,28,74,7665,2949,1376,5.554049575635191,0.34428783783783784
2019-06-12,33,9,21,63,7841,3024,1493,5.844672008052956,0.34106507936507935
2019-06-13,32,5,24,61,6434,2289,934,5.688082560667101,0.37492950819672133
2019-06-14,52,4,31,87,8200,3061,1449,5.721380072337439,0.49154827586206895
2019-06-15,26,12,21,59,5310,1918,912,5.713659923652548,0.235364406779661
2019-06-16,45,20,19,84,9596,3583,1823,5.625560785307997,0.28812738095238094
2019-06-17,45,8,29,82,7443,2845,1378,5.521010260945555,0.41677804878048785
2019-06-18,53,15,27,95,10377,3865,1532,5.589389607582606,0.37736210526315794
2019-06-19,43,13,17,73,13808,5261,930,5.795521934766442,0.3405876712328767
2019-06-20,55,12,46,113,11294,4324,1612,5.563216524078161,0.33220265486725664
2019-06-21,66,18,42,126,18674,7389,1709,5.58208525629918,0.34112301587301586
2019-06-22,67,16,75,158,13096,4924,1900,5.3025589165015115,0.2968512658227848
2019-06-23,53,20,41,114,10676,4190,2009,5.672262448319953,0.26871491228070177
2019-06-24,63,12,39,114,10500,4098,1744,5.642043923691306,0.3963131578947368
2019-06-25,74,22,39,135,11611,4423,2233,5.50109838175838,0.3562133333333333
2019-06-26,145,39,146,330,24357,9498,3624,5.405155123050455,0.27403636363636363
2019-06-27,90,27,82,199,17292,6606,2374,5.400244239457231,0.30444120603015074
2019-06-28,70,18,52,140,15893,6284,2078,5.494212725156813,0.28738142857142857
2019-06-29,52,15,34,101,9608,3705,1540,5.437013833111045,0.3339554455445545
2019-06-30,31,12,44,87,11242,4384,1508,5.541015326810178,0.22216206896551724
2019-07-01,50,12,35,97,12692,4819,1496,5.674516174234389,0.37509896907216494
2019-07-02,54,13,42,109,12055,4592,1941,5.594863367994292,0.35268990825688074
2019-07-03,56,15,42,113,11957,4673,1601,5.612488392627385,0.2868973451327434
2019-07-04,57,15,30,102,10255,3955,1562,5.5548730032306946,0.33972745098039214
2019-07-05,42,3,24,69,8847,3445,1293,5.80045310153892,0.4893753623188406
2019-07-06,43,6,16,65,6084,2218,1661,5.546430428767811,0.4746276923076923
2019-07-07,48,13,25,86,9032,3476,2212,5.533387950895355,0.33416744186046515
2019-07-08,44,13,33,90,14706,5690,1244,5.625394112525444,0.34669777777777777
2019-07-09,54,16,31,101,12062,4721,1708,5.6073126762373295,0.3207514851485148
2019-07-10,69,18,53,140,14061,5594,1861,5.52339738326012,0.34813642857142857
2019-07-11,46,15,35,96,8250,3146,1478,5.645826837632178,0.31792916666666665
2019-07-12,47,18,36,101,13140,5326,1422,5.531794036484298,0.2625891089108911
2019-07-13,48,13,23,84,9689,3725,1493,5.691170269990905,0.3710654761904762
2019-07-14,45,7,30,82,10861,4286,2195,5.655578719761199,0.3865390243902439
2019-07-15,62,13,24,99,17634,6705,1413,5.677884031526763,0.4311929292929293
2019-07-16,47,16,38,101,13187,5082,2360,5.562363631795548,0.2898940594059406
2019-07-17,62,16,47,125,17646,6691,1667,5.633569317222958,0.3350088
2019-07-18,61,10,25,96,10234,3888,1668,5.721462343338011,0.43911666666666666
2019-07-19,46,17,32,95,11488,4516,1602,5.5252769315412005,0.2552831578947368
2019-07-20,47,10,22,79,8149,3147,2047,5.448496434570858,0.41351772151898736
2019-07-21,52,14,26,92,12556,5116,2572,5.608103103750008,0.341279347826087
2019-07-22,54,9,36,99,8855,3268,2161,5.760903657326517,0.404230303030303
2019-07-23,52,12,35,99,9748,3672,1969,5.665145452970316,0.3064828282828283
2019-07-24,50,12,24,86,10488,3997,1449,5.718957012091293,0.40169186046511624
2019-07-25,48,21,27,96,13058,5269,2102,5.6405035673338135,0.279215625
2019-07-26,38,18,24,80,9591,3636,1592,5.820939645971016,0.22719499999999998
2019-07-27,33,14,26,73,8670,3222,1327,5.535585286570572,0.21088356164383562
2019-07-28,37,11,22,70,6512,2377,1552,5.677149569616535,0.32314714285714286
2019-07-29,48,15,24,87,12040,4684,1167,5.664395875272741,0.2989344827586207
2019-07-30,56,17,29,102,13775,5155,1850,5.787300609488677,0.37653431372549023
2019-07-31,54,16,34,104,13179,5106,2335,5.659148622396585,0.2729201923076923
2019-08-01,47,14,21,82,12436,4577,1351,5.79491545323506,0.4161024390243902
2019-08-02,47,10,27,84,9998,3775,2073,5.685653472189268,0.3517869047619048
2019-08-03,38,11,29,78,8105,3033,1542,5.632141039768659,0.2956551282051282
2019-08-04,41,8,20,69,5823,2250,1450,5.728000853518953,0.4088898550724638
2019-08-05,65,7,40,112,11188,4181,1691,5.58801683848896,0.44672232142857143
2019-08-06,46,14,32,92,8896,3380,1882,5.6445007810735675,0.3000413043478261
2019-08-07,47,14,21,82,10332,3911,1908,5.661593276829778,0.34180609756097563
2019-08-08,46,8,27,81,10330,3921,1337,5.567241165766754,0.4175308641975309
2019-08-09,36,12,23,71,7172,2709,1121,5.785854329414734,0.30646197183098595
2019-08-10,50,10,28,88,9640,3710,1353,5.591996054422993,0.4123431818181818
2019-08-11,34,10,29,73,11164,4457,1604,5.714329695611452,0.31246027397260273
2019-08-12,51,13,23,87,13075,4946,1446,5.838651355642293,0.39440114942528737
2019-08-13,37,14,24,75,9351,3622,1658,5.885970859631027,0.2598693333333333
2019-08-14,48,8,30,86,12929,5199,1509,5.6554376001954765,0.40538837209302325
2019-08-15,41,10,16,67,7180,2742,950,5.6079311965161525,0.45531044776119406
2019-08-16,35,14,20,69,6886,2581,1074,5.518184866327845,0.2690913043478261
2019-08-17,35,8,17,60,5981,2358,1158,5.536488063791467,0.36688833333333337
2019-08-18,29,9,27,65,5952,2165,1353,5.576734882435949,0.2786584615384615
2019-08-19,34,19,24,77,6493,2541,1333,5.504642606964432,0.15492077922077924
2019-08-20,57,13,34,104,13006,5046,1393,5.6539915965844765,0.35777980769230766
2019-08-21,40,6,36,82,10360,3871,1313,5.7920352594876,0.39270609756097563
2019-08-22,41,13,25,79,7166,2736,1016,5.73463446545722,0.31104050632911395
2019-08-23,31,15,30,76,7966,3193,1325,5.4769423055202555,0.21996973684210527
2019-08-24,34,14,25,73,8503,3244,1378,5.74971230074681,0.27695479452054794
2019-08-25,33,15,22,70,6857,2630,1369,5.60952835202353,0.20893857142857142
2019-08-26,35,16,16,67,8446,3223,1214,5.707357102292827,0.28414626865671644
2019-08-27,41,11,37,89,10113,3889,1267,5.48245727081414,0.3046741573033708
2019-08-28,43,17,26,86,12949,5016,1309,5.717618987038245,0.2861523255813953
2019-08-29,32,8,28,68,6722,2473,881,5.775469144790054,0.32025441176470587
2019-08-30,32,8,20,60,6572,2499,1026,5.489224395346862,0.4049666666666667
2019-08-31,35,7,17,59,5941,2252,747,5.689457731445412,0.41547966101694916
2019-09-01,17,8,19,44,6453,2318,1407,5.821704615881537,0.211075
2019-09-02,35,13,20,68,7414,2804,1247,5.768063393420744,0.2557014705882353
2019-09-03,36,10,24,70,7724,2941,1119,5.714834283062018,0.3588657142857143
2019-09-04,37,13,22,72,8022,3022,1124,5.7224178333732105,0.3187319444444444
2019-09-05,32,10,21,63,7447,2852,1059,5.666711444640108,0.36495714285714287
2019-09-06,29,10,16,55,6235,2433,941,5.79600182856936,0.37672
2019-09-07,32,6,20,58,4518,1738,971,5.555872772411002,0.3770310344827586
2019-09-08,27,7,13,47,9787,4333,928,5.556678353255617,0.3845936170212766
2019-09-09,33,8,10,51,7281,2814,837,5.790788091636751,0.3892058823529412
2019-09-10,26,7,23,56,5706,2107,814,5.657866896435266,0.29666607142857143
2019-09-11,45,8,17,70,8445,3333,1030,5.721135582932641,0.4673957142857143
2019-09-12,31,9,19,59,6247,2333,850,5.540056195827258,0.27418305084745764
2019-09-13,23,9,29,61,8915,3426,1233,5.65765396003039,0.25733770491803276
2019-09-14,18,11,12,41,4503,1709,477,5.740441090329959,0.12983902439024392
2019-09-15,21,5,8,34,3416,1165,538,5.7078556128205085,0.41451470588235295
2019-09-16,35,10,20,65,7884,2916,816,5.650631307316305,0.37231846153846154
2019-09-17,37,11,24,72,7551,2790,1308,5.673404628755301,0.3047597222222222
2019-09-18,29,6,16,51,5898,2307,1051,5.696568401341744,0.4021
2019-09-19,35,12,24,71,11954,4517,1570,5.7112256350807735,0.2897676056338028
2019-09-20,32,12,12,56,6655,2479,977,5.6732418470591535,0.3046357142857143
2019-09-21,23,6,23,52,5965,2249,865,5.874419515400659,0.3163019230769231
2019-09-22,30,7,22,59,7392,2929,1177,5.884005776161571,0.365671186440678
2019-09-23,25,6,15,46,4775,1819,690,5.476365055071317,0.40139130434782605
2019-09-24,37,14,28,79,9638,3700,1309,5.644627298074762,0.26824050632911395
2019-09-25,32,11,35,78,6054,2216,869,5.53269972370931,0.22323333333333337
2019-09-26,44,12,29,85,9546,3729,1811,5.628229408882431,0.3140411764705882
2019-09-27,38,19,24,81,7853,3049,1137,5.669400129145872,0.1894074074074074
2019-09-28,20,7,13,40,3978,1414,661,5.605581636145285,0.32667999999999997
2019-09-29,29,6,23,58,8938,3435,1377,5.8911881109426645,0.3741913793103448
2019-09-30,32,5,28,65,6824,2510,933,5.403639873986651,0.3399707692307692
2019-10-01,23,9,13,45,4615,1638,1059,5.654659057194632,0.2694066666666667
2019-10-02,41,8,22,71,7543,2953,1403,5.70541141015363,0.4064605633802817
2019-10-03,24,13,22,59,5061,1912,1241,5.8351447756117345,0.1949050847457627
2019-10-04,28,9,22,59,7050,2640,1011,6.288032610258483,0.32238305084745766
2019-10-05,24,11,19,54,5753,1903,1148,5.601076216886945,0.22493148148148148
2019-10-06,21,8,13,42,4842,1911,973,5.580262606851366,0.24910714285714286
2019-10-07,26,14,16,56,7527,2768,1215,5.575807630462749,0.20698392857142855
2019-10-08,27,7,15,49,6743,2582,797,5.904234815439293,0.3848673469387755
2019-10-09,37,11,27,75,5973,2213,920,5.488197696043152,0.32339466666666666
2019-10-10,23,6,25,54,5797,2320,823,5.694639223198021,0.26494814814814815
2019-10-11,19,11,19,49,6958,2654,954,5.799851456007179,0.17926530612244898
2019-10-12,34,6,10,50,5608,2169,858,5.695900677566386,0.459126
2019-10-13,22,6,17,45,4791,1926,936,5.7015974435594465,0.34188444444444444
2019-10-14,32,7,17,56,5599,2049,870,5.801032573354741,0.3500875
2019-10-15,39,13,18,70,9592,3508,858,5.7332513325842065,0.3005885714285714
2019-10-16,34,10,25,69,7274,2742,774,5.632131047565184,0.33700434782608696
2019-10-17,33,4,14,51,6686,2517,907,5.897247236709315,0.47707647058823527
2019-10-18,32,6,28,66,7274,2794,1487,5.551335949161801,0.37898181818181814
2019-10-19,31,6,14,51,5607,2218,887,5.716240471532467,0.32547450980392156
2019-10-20,28,9,20,57,5380,2057,955,5.607573144315884,0.332719298245614
2019-10-21,24,3,20,47,4877,1835,617,5.552265801174912,0.3743468085106383
2019-10-22,32,8,20,60,5825,2123,901,5.602344858460483,0.355975
2019-10-23,33,12,30,75,9269,3440,2026,5.666096172095433,0.20749199999999998
2019-10-24,35,11,16,62,9734,3808,1456,5.679907510553977,0.3017290322580645
2019-10-25,43,7,30,80,7861,2973,1021,5.569811716021524,0.39915249999999997
2019-10-26,25,13,31,69,5607,1993,1237,5.621938725078155,0.21707246376811593
2019-10-27,38,15,23,76,7162,2625,1500,5.621577760544848,0.23407368421052632
2019-10-28,31,11,22,64,5550,2110,1111,5.429349616311831,0.2911390625
2019-10-29,25,5,20,50,6393,2443,979,5.775784518151596,0.34181799999999996
2019-10-30,36,8,27,71,8347,3131,1031,5.928140384471071,0.3756140845070422
2019-10-31,40,14,17,71,8485,3350,930,5.7020712553814885,0.3550239436619719
2019-11-01,38,9,25,72,10286,3994,1382,5.657879508984219,0.357175
2019-11-02,22,17,19,58,6202,2494,996,5.825306743921297,0.08491724137931035
2019-11-03,23,6,14,43,6181,2262,874,5.644159308130708,0.2929046511627907
2019-11-04,38,7,21,66,14004,5360,1247,5.799156938663656,0.43668636363636365
2019-11-05,38,6,17,61,5788,2185,969,6.239544164328954,0.4257704918032787
2019-11-06,28,6,14,48,6523,2373,972,5.684542344687828,0.3965604166666667
2019-11-07,34,6,19,59,6462,2402,948,5.707632126063874,0.3852372881355932
2019-11-08,34,8,16,58,9479,3548,1038,5.817655543221684,0.4057051724137931
2019-11-09,20,3,11,34,4395,1746,888,5.797710018742649,0.4269764705882353
2019-11-10,25,7,13,45,9900,3960,778,5.9844135031934504,0.31106
2019-11-11,30,8,19,57,6379,2376,963,5.615386157057994,0.37906842105263155
2019-11-12,32,7,12,51,7100,2552,773,5.67106333350361,0.45116078431372547
2019-11-13,36,7,15,58,6755,2498,867,5.677270049902392,0.40511551724137934
2019-11-14,37,9,15,61,7088,2625,824,5.720900190767582,0.39012295081967213
2019-11-15,40,13,24,77,12037,3828,1346,5.656776723995438,0.34032597402597403
2019-11-16,14,6,13,33,4419,1578,526,5.792858978993738,0.24097878787878788
2019-11-17,23,8,12,43,5673,2168,1048,5.767309565964403,0.3560720930232558
2019-11-18,30,5,20,55,4666,1756,1156,5.496037663928113,0.3641927272727273
2019-11-19,28,17,17,62,6231,2180,1415,5.71781398586533,0.19515806451612902
2019-11-20,31,7,13,51,5738,2097,707,5.734083829232905,0.39271960784313725
2019-11-21,28,14,16,58,8121,3209,912,5.550669352063947,0.1894310344827586
2019-11-22,26,17,32,75,12181,4458,1198,5.616850881702739,0.14468666666666666
2019-11-23,20,13,15,48,8166,3089,1061,5.6916318944812865,0.19510416666666666
2019-11-24,19,10,24,53,5307,1870,641,5.734635720639284,0.20321509433962265
2019-11-25,31,7,24,62,6538,2510,1038,5.648064594974811,0.3338516129032258
2019-11-26,28,10,16,54,6140,2172,1094,5.651217892782448,0.2571888888888889
2019-11-27,40,9,14,63,9059,3562,978,5.531286321586837,0.43135396825396827
2019-11-28,27,5,13,45,4439,1711,787,5.783876955089624,0.44223555555555555
2019-11-29,31,9,15,55,6890,2551,1122,5.752500681643983,0.3643945454545454
2019-11-30,20,10,18,48,4947,1890,818,5.480100294252973,0.25695208333333336
2019-12-01,32,7,20,59,5165,1980,1152,5.402378468619342,0.3819050847457627
2019-12-02,38,7,19,64,6118,2288,803,5.7352384030107855,0.4255875
2019-12-03,39,10,21,70,6713,2453,1003,5.759780259714268,0.3630185714285714
2019-12-04,33,7,21,61,5859,2179,1436,5.557445264570452,0.3816803278688524
2019-12-05,32,10,17,59,7844,2965,982,5.648348052353485,0.34398813559322033
2019-12-06,37,15,17,69,8670,3379,1436,5.689989407114875,0.2997159420289855
2019-12-07,20,7,11,38,6413,1913,351,5.686242117039546,0.2785815789473684
2019-12-08,24,3,16,43,4902,1764,513,5.6961222676718535,0.36748837209302326
2019-12-09,34,10,11,55,6918,2545,708,5.694052259586094,0.39644
2019-12-10,31,8,17,56,6066,2236,996,5.731581035274211,0.35661785714285715
2019-12-11,31,8,16,55,6572,2558,966,5.782426824061396,0.33992181818181816
2019-12-12,23,13,15,51,5357,2073,788,5.627422459133782,0.13984313725490197
2019-12-13,21,6,13,40,4748,1742,495,5.4739223629699705,0.318735
2019-12-14,20,9,18,47,5744,2051,960,5.8885451067465535,0.2697914893617021
2019-12-15,31,10,8,49,9562,3911,1410,5.884021797692442,0.3686102040816327
2019-12-16,38,6,18,62,5817,2137,937,5.618012343123702,0.46066129032258063
2019-12-17,39,13,23,75,8360,3214,1323,5.56950910691088,0.32464
2019-12-18,24,9,23,56,6291,2251,705,5.750851881452995,0.27987321428571427
2019-12-19,30,8,16,54,6159,2414,903,5.713378409738441,0.3830518518518518
2019-12-20,23,7,16,46,5665,2163,803,5.645513327772671,0.32995
2019-12-21,19,7,17,43,3295,1240,543,5.513858907443446,0.3156581395348837
2019-12-22,24,5,7,36,4479,1663,424,5.715280690935663,0.42504444444444445
2019-12-23,34,9,12,55,6371,2402,1259,5.619952083182708,0.44366727272727274
2019-12-24,21,12,12,45,6590,2408,561,5.719109431756537,0.20111555555555555
2019-12-25,27,8,7,42,7211,2670,766,5.6842832979037645,0.43220238095238095
2019-12-26,20,7,13,40,5075,1899,602,5.970393443026138,0.28329499999999996
2019-12-27,28,8,16,52,5732,2260,844,5.780372553683259,0.3555057692307692
2019-12-28,20,5,20,45,4020,1576,635,5.6649251170262085,0.2756266666666667
2019-12-29,20,3,11,34,3025,1074,707,5.409197242873027,0.46806176470588234
2019-12-30,36,3,24,63,6284,2416,1129,5.570257482356556,0.4779984126984127
2019-12-31,23,11,13,47,7158,2824,926,5.494374765886089,0.2999893617021277
2020-01-01,30,7,14,51,5310,1759,806,5.714133267739819,0.37085098039215686
2020-01-02,31,10,19,60,7824,3002,1004,5.612542002055661,0.32459333333333334
2020-01-03,29,11,21,61,8171,3298,1592,5.531564302954541,0.2841475409836066
2020-01-04,30,10,24,64,6421,2438,1337,5.671267089588552,0.285128125
2020-01-05,36,8,15,59,6011,2066,866,5.633013639828652,0.42376949152542376
2020-01-06,34,10,14,58,7637,2851,1010,5.628222761335382,0.35672758620689654
2020-01-07,23,7,25,55,4798,1785,1105,5.701484749434677,0.23770727272727274
2020-01-08,40,8,21,69,7787,3025,1023,5.5900824843107975,0.3818884057971015
2020-01-09,32,7,11,50,7488,2893,831,5.567978848952711,0.44102600000000003
2020-01-10,33,9,16,58,6025,2115,1031,5.472220759189699,0.39907241379310343
2020-01-11,24,2,14,40,4988,1837,713,5.609016474563944,0.5124225
2020-01-12,25,5,14,44,3801,1412,667,5.455715504355293,0.38577954545454546
2020-01-13,31,8,8,47,4462,1658,693,5.6607507769782455,0.392831914893617
2020-01-14,42,15,33,90,10568,4159,1725,5.435160202321278,0.2582611111111111
2020-01-15,30,8,29,67,4998,1913,1300,5.627234635736497,0.27637462686567166
2020-01-16,33,8,22,63,6682,2700,768,5.706790299222943,0.3406031746031746
2020-01-17,29,10,21,60,7778,3158,1023,5.704021500935574,0.26789833333333335
2020-01-18,26,12,14,52,3997,1453,731,5.54198713606821,0.26706538461538465
2020-01-19,26,6,22,54,3936,1455,603,5.602829072980573,0.31631296296296296
2020-01-20,24,8,21,53,4747,1764,674,5.541922752763847,0.27735849056603773
2020-01-21,40,8,19,67,10118,3946,1233,5.651337291770678,0.4289
2020-01-22,26,7,14,47,5093,1849,594,5.682376531305026,0.3453489361702128
2020-01-23,42,19,17,78,11284,4390,2488,5.619195883177925,0.320575641025641
2020-01-24,47,14,29,90,16097,6467,2383,5.790686878875554,0.3248011111111111
2020-01-25,32,6,17,55,8603,3461,1313,5.787306450619845,0.4812945454545455
2020-01-26,48,10,18,76,9065,3648,1557,5.722317380775217,0.41098289473684213
2020-01-27,63,6,28,97,12136,4659,1561,5.7013286324941355,0.508579381443299
2020-01-28,40,9,20,69,7577,2846,1037,5.720794411379102,0.40114057971014494
2020-01-29,47,4,23,74,7608,2954,1167,5.435062731714509,0.4888054054054054
2020-01-30,34,11,32,77,9180,3385,1956,5.650943693079392,0.28763376623376624
2020-01-31,24,7,23,54,9933,3925,810,5.672392229875266,0.3325166666666667
2020-02-01,23,5,19,47,5037,1847,1371,5.449233319389879,0.35130638297872335
2020-02-02,25,7,29,61,5344,2034,1049,5.441333019520175,0.2955852459016393
2020-02-03,36,6,24,66,6172,2365,999,5.499021681812749,0.39583484848484846
2020-02-04,30,7,15,52,4934,1832,623,5.5128612837584265,0.37590961538461537
2020-02-05,38,12,24,74,7009,2700,1189,5.808270401555783,0.2649324324324324
2020-02-06,28,16,33,77,6984,2654,1034,5.57439606778121,0.16832727272727271
2020-02-07,39,8,14,61,10972,4092,1508,5.714508534072062,0.44867704918032786
2020-02-08,20,6,20,46,4689,1797,708,5.647661574896935,0.25905434782608694
2020-02-09,41,12,28,81,8692,3229,1241,5.473157663048671,0.35530864197530865
2020-02-10,43,8,17,68,8013,3092,1016,5.623807875344966,0.46693676470588236
2020-02-11,44,8,20,72,6106,2336,905,5.781741128187836,0.3988611111111111
2020-02-12,46,12,33,91,8146,3157,1340,5.562153934742845,0.35162857142857146
2020-02-13,35,9,24,68,9593,3719,1751,5.6380921168331,0.3133867647058824
2020-02-14,39,11,27,77,9541,3621,1125,5.5045424086626635,0.30127922077922076
2020-02-15,43,9,27,79,9614,3681,1165,5.65940146136732,0.33541898734177217
2020-02-16,48,11,35,94,10741,3990,2241,5.732453842368785,0.36198510638297876
2020-02-17,53,10,23,86,11436,4478,1820,5.790359130362323,0.4561755813953488
2020-02-18,34,14,35,83,8572,3260,1280,5.535069214454296,0.23956265060240964
2020-02-19,43,16,21,80,12008,4743,1268,5.712532278738093,0.33379375
2020-02-20,42,11,23,76,7720,2844,1381,5.721456203490675,0.32703552631578947
2020-02-21,28,12,27,67,7801,2963,1515,5.762225388106872,0.23035820895522388
2020-02-22,32,10,21,63,8303,3268,1518,5.708383131850824,0.3341365079365079
2020-02-23,33,9,20,62,8036,3034,920,5.831062754579626,0.355491935483871
2020-02-24,34,8,22,64,7507,2826,998,5.590385241858182,0.3706640625
2020-02-25,36,13,19,68,7605,2858,1210,5.579170602855696,0.2648941176470588
2020-02-26,49,14,30,93,8603,3097,1089,5.695575750645299,0.3193172043010753
2020-02-27,36,11,15,62,5464,1976,559,5.755466293112904,0.35983387096774194
2020-02-28,38,12,25,75,7570,2745,1432,5.666455302227139,0.26570533333333335
2020-02-29,22,8,23,53,4822,1776,869,6.003357945181856,0.20780188679245284
2020-03-01,25,9,21,55,5776,2291,1190,5.810710178188182,0.29817454545454547
2020-03-02,42,7,26,75,6769,2576,1141,5.632911589607122,0.4039493333333333
2020-03-03,29,11,25,65,6095,2336,766,5.651018158913854,0.25093230769230773
2020-03-04,36,6,24,66,7403,2872,936,5.6405963558558545,0.3625590909090909
2020-03-05,28,11,22,61,3956,1426,1197,5.600468108698624,0.26191639344262296
2020-03-06,24,7,18,49,5051,1889,539,5.806127876706892,0.3403285714285715
2020-03-07,18,6,17,41,4554,1665,1047,5.8443122477104925,0.3115560975609756
2020-03-08,26,9,8,43,5576,2176,1599,5.567867293810211,0.34413488372093026
2020-03-09,34,12,30,76,6275,2320,1209,5.645213185755786,0.25940394736842104
2020-03-10,22,11,27,60,5187,2031,660,5.637773935537597,0.13695333333333334
2020-03-11,29,10,19,58,5073,2038,1193,5.620029236055892,0.2740551724137931
2020-03-12,56,30,73,159,12340,4811,2311,5.45163313134828,0.14852704402515723
2020-03-13,83,37,90,210,15426,6172,2139,5.432295848479615,0.2152352380952381
2020-03-14,45,12,22,79,7326,2853,1761,5.583150631597618,0.3371329113924051
2020-03-15,41,24,27,92,11062,4441,1329,5.464738803709905,0.17901304347826089
2020-03-16,61,22,47,130,12695,5020,1755,5.483381455744558,0.23365307692307694
2020-03-17,37,17,32,86,8509,3414,1163,5.628882184974231,0.23006046511627906
2020-03-18,49,13,31,93,10633,4116,1110,5.497752923943669,0.35704086021505377
2020-03-19,58,13,38,109,9769,3723,1232,5.542593155898173,0.35902752293577983
2020-03-20,49,14,21,84,8071,3152,964,5.659100107193926,0.33363095238095236
2020-03-21,35,14,25,74,6178,2296,1371,5.5822256870767255,0.24782297297297295
2020-03-22,38,7,23,68,5419,2136,1039,5.652153834766113,0.3701911764705882
2020-03-23,43,14,16,73,9273,3599,1000,5.765717810867175,0.3419027397260274
2020-03-24,39,9,31,79,7272,2802,783,5.555096991459829,0.3714189873417722
2020-03-25,39,13,29,81,8161,3072,792,5.739411834397845,0.27302345679012346
2020-03-26,29,6,20,55,10112,3835,1307,5.69680243013854,0.37022363636363637
2020-03-27,25,13,20,58,4977,1902,805,5.556256622916429,0.19088793103448276
2020-03-28,23,10,33,66,5801,2340,1048,5.567555559312001,0.18352727272727273
2020-03-29,19,7,19,45,2933,1104,602,5.656752012510562,0.2648911111111111
2020-03-30,37,8,24,69,6582,2584,1005,5.5593029314566795,0.4170449275362319
2020-03-31,31,8,26,65,7199,2805,759,5.7226243709897755,0.3574492307692308
2020-04-01,39,8,20,67,6535,2474,642,5.722146030356028,0.43190746268656716
2020-04-02,32,6,22,60,6040,2281,896,5.676221655778574,0.3971416666666666
2020-04-03,37,7,28,72,5858,2166,827,5.682835172791166,0.3743486111111111
2020-04-04,23,8,34,65,5964,2282,1075,5.428065424558155,0.21327076923076924
2020-04-05,32,1,22,55,6707,2610,664,5.579157953498256,0.5320818181818182
2020-04-06,23,11,20,54,5005,1862,1014,5.533912278578593,0.1669351851851852
2020-04-07,25,13,29,67,6317,2517,1056,5.569916075608243,0.19949701492537314
2020-04-08,29,6,21,56,6006,2245,1298,5.669878654245079,0.33312857142857144
2020-04-09,37,6,31,74,6667,2678,797,5.445514997420131,0.3453702702702703
2020-04-10,52,12,25,89,12808,5048,1437,5.661682613612778,0.3902741573033708
2020-04-11,40,5,25,70,6274,2389,970,5.740258092460628,0.42867571428571427
2020-04-12,26,9,16,51,4554,1693,742,5.705909916646257,0.33155294117647055
2020-04-13,40,13,36,89,10053,3995,1493,5.6452881368546395,0.3094651685393259
2020-04-14,56,17,28,101,10274,3950,1254,5.631099013831714,0.32203960396039605
2020-04-15,37,11,28,76,10572,4113,1670,5.5079332792767595,0.3192894736842105
2020-04-16,49,9,23,81,9015,3390,1209,5.7137208028697675,0.4072580246913581
2020-04-17,49,11,27,87,8221,3013,1051,5.623887298479635,0.37208390804597696
2020-04-18,36,16,20,72,6114,2363,1265,5.608513584614173,0.26135694444444446
2020-04-19,51,11,32,94,11475,4391,1382,5.7620576722158425,0.388531914893617
2020-04-20,53,11,16,80,10015,3744,813,5.674698868371934,0.4386775
2020-04-21,42,12,27,81,10117,3993,1163,5.691132408468009,0.33580123456790123
2020-04-22,53,11,25,89,11219,4370,1261,5.561492988258716,0.4312078651685393
2020-04-23,37,13,33,83,6957,2668,1211,5.456958503451312,0.2767831325301205
2020-04-24,47,12,28,87,13065,5061,1257,5.693491429061112,0.3653885057471264
2020-04-25,56,12,29,97,10003,3751,1385,5.478475953501691,0.3983051546391753
2020-04-26,40,16,35,91,8769,3384,1338,5.626748233965333,0.23534835164835163
2020-04-27,59,14,40,113,11509,4351,1323,5.6912138932216765,0.40716283185840707
2020-04-28,58,14,44,116,12412,4761,1052,5.503683297654354,0.3482879310344828
2020-04-29,69,33,70,172,18427,7070,7,5.549739495293333,0.16028372093023255
2020-04-30,86,36,79,201,15780,5981,16,5.456001836036876,0.22197263681592042
2020-05-01,52,8,27,87,7735,2905,1226,5.676317746273548,0.4145229885057471
2020-05-02,42,6,37,85,6204,2451,849,5.695277238466333,0.3454741176470588
2020-05-03,37,11,22,70,8751,3377,870,5.840684490985453,0.2851742857142857
2020-05-04,35,12,26,73,7549,2890,1108,5.590962508640666,0.2786246575342466
2020-05-05,50,14,37,101,9996,3816,1133,5.626794152211073,0.3203316831683168
2020-05-06,41,15,33,89,10171,3938,1325,5.48887126530869,0.25643146067415734
2020-05-07,69,13,53,135,15581,6089,3402,5.465936261891917,0.35605925925925924
2020-05-08,62,13,49,124,11166,4265,1669,5.591733064374086,0.34493629032258066
2020-05-09,52,8,18,78,7682,2922,966,5.520049603649158,0.4581628205128205
2020-05-10,64,20,53,137,14966,5897,1788,5.610710295959921,0.27504379562043796
2020-05-11,82,22,61,165,14137,5416,4468,5.586332995214433,0.33137272727272726
2020-05-12,58,15,43,116,10462,3978,1407,5.6172278064566346,0.3287827586206897
2020-05-13,44,19,48,111,9152,3476,1099,5.529605015812015,0.2264099099099099
2020-05-14,66,16,35,117,11423,4333,1340,5.538129151262143,0.3828897435897436
2020-05-15,57,24,55,136,12809,5001,2148,5.576203241938445,0.24658529411764707
2020-05-16,39,16,35,90,8160,3163,1560,5.586345259361627,0.23835222222222222
2020-05-17,64,14,28,106,12901,4973,1844,5.603534492993417,0.43372735849056604
2020-05-18,55,17,41,113,11750,4440,1605,5.730988091790567,0.29470353982300884
2020-05-19,52,19,42,113,10055,3863,1883,5.535971247374174,0.2867778761061947
2020-05-20,45,11,39,95,10430,4070,1363,5.597343647637889,0.35630842105263155
2020-05-21,72,24,32,128,16141,6168,1721,5.606607421991759,0.32577890625
2020-05-22,72,15,36,123,12863,4948,1335,5.628656905844068,0.42910487804878045
2020-05-23,40,10,28,78,9453,3399,986,5.533651363943397,0.34138974358974356
2020-05-24,43,9,20,72,6552,2498,1083,5.753501754504622,0.39071805555555555
2020-05-25,44,17,35,96,8890,3389,1925,5.5018873852918375,0.24225729166666665
2020-05-26,43,13,35,91,7514,2849,1753,5.6731034193821195,0.32661648351648354
2020-05-27,49,9,26,84,10083,3683,1196,5.626245901733436,0.38246547619047616
2020-05-28,56,10,19,85,8584,3352,1085,5.73922956235881,0.45129176470588234
2020-05-29,48,7,18,73,5445,1902,954,5.550149844654431,0.4843835616438356
2020-05-30,36,9,23,68,7260,2788,897,5.680428946375303,0.33390000000000003
2020-05-31,27,9,22,58,5882,2241,978,5.6492796412589374,0.2886775862068966
2020-06-01,41,10,24,75,6134,2210,890,5.563461556802265,0.3557106666666667
2020-06-02,53,16,34,103,9596,3622,1278,5.589524493540318,0.33662330097087384
2020-06-03,41,8,36,85,10707,4105,1013,5.663231524539642,0.3827117647058823
2020-06-04,33,10,23,66,7426,2766,799,5.562200606740693,0.3158666666666667
2020-06-05,54,18,22,94,11987,4577,939,5.69263633040148,0.33991702127659573
2020-06-06,49,9,23,81,8360,2619,1534,5.580462590951813,0.40783950617283954
2020-06-07,32,7,22,61,5423,1957,919,5.701751541906106,0.3372426229508197
2020-06-08,46,6,31,83,8915,3433,915,5.655420580976997,0.41948313253012054
2020-06-09,44,7,24,75,7573,2875,1013,5.640462595361775,0.45536
2020-06-10,38,7,29,74,8665,3323,1110,5.722668262162385,0.38303648648648647
2020-06-11,42,10,24,76,8338,3149,889,5.559953668882637,0.37746052631578947
2020-06-12,34,9,22,65,6734,2586,854,5.770831051957722,0.35572
2020-06-13,23,14,18,55,6208,2448,928,5.514314064801169,0.11743272727272727
2020-06-14,24,11,23,58,5565,2113,1016,5.738046676411698,0.24088448275862068
2020-06-15,45,7,25,77,8048,3063,1118,5.637382385321709,0.44905194805194804
2020-06-16,34,7,26,67,7968,3007,940,5.737992650823856,0.37893432835820895
2020-06-17,40,11,24,75,11200,4188,993,5.76407980986505,0.33749066666666666
2020-06-18,46,9,28,83,7884,2869,1241,5.636036588532465,0.39134578313253016
2020-06-19,31,14,26,71,6854,2556,852,5.632506774886911,0.25751549295774645
2020-06-20,33,10,17,60,5540,2175,965,5.705878416503973,0.35136833333333334
2020-06-21,24,9,17,50,4944,1974,699,5.67031298482302,0.282786
2020-06-22,28,8,14,50,6157,2280,618,5.657616855221977,0.341356
2020-06-23,38,13,20,71,6802,2655,657,5.56408085129034,0.29995070422535214
2020-06-24,28,7,35,70,6268,2326,948,5.762175943383475,0.30613428571428575
2020-06-25,26,9,20,55,5601,2059,953,5.624094289039702,0.27536727272727274
2020-06-26,25,4,17,46,4687,1767,648,5.666196103805419,0.3845586956521739
2020-06-27,20,12,21,53,6091,2348,1112,5.752914870598102,0.16954716981132076
2020-06-28,24,4,19,47,4270,1652,751,5.622461750163649,0.3855
2020-06-29,25,10,15,50,4781,1775,456,5.5592131622484775,0.253708
2020-06-30,36,2,21,59,8888,3357,1138,5.615931568717636,0.4812949152542373
2020-07-01,24,11,16,51,7072,2828,1061,5.5815668190369925,0.2259549019607843
2020-07-02,22,6,16,44,4245,1521,460,5.662709015871297,0.29701363636363637
2020-07-03,33,8,23,64,5337,1977,747,5.459437989012024,0.3639390625
2020-07-04,27,13,15,55,4663,1727,1103,5.5180313160783045,0.2507436363636364
2020-07-05,25,4,22,51,4214,1608,759,5.534276775069102,0.37814313725490195
2020-07-06,31,9,19,59,4745,1749,726,5.581635593361583,0.29604237288135593
2020-07-07,36,6,12,54,8386,3338,784,5.578915158269499,0.5118944444444444
2020-07-08,28,7,22,57,5356,1970,715,5.630301552125129,0.3600035087719298
2020-07-09,33,10,23,66,6080,2320,1296,5.626490344206991,0.29431666666666667
2020-07-10,26,4,13,43,9166,3580,500,5.715846030476396,0.5014860465116279
2020-07-11,20,6,14,40,3130,1206,522,5.519102914322259,0.321805
2020-07-12,16,5,14,35,2886,1175,458,5.562926220359472,0.29078857142857145
2020-07-13,28,6,18,52,3983,1458,818,5.675432952018431,0.3975480769230769
2020-07-14,27,10,11,48,7793,2968,575,5.598687321819881,0.32252291666666666
2020-07-15,29,12,21,62,10901,4343,997,5.729521471572615,0.24326774193548387
2020-07-16,29,13,21,63,9351,3634,702,5.8953986774437865,0.23553174603174604
2020-07-17,28,4,22,54,5005,1845,608,5.650723287819757,0.37145
2020-07-18,19,4,15,38,3289,1253,586,5.806011341328816,0.32398947368421055
2020-07-19,18,4,7,29,2938,1140,560,5.816666698711439,0.39156896551724135
2020-07-20,30,7,19,56,5699,2256,646,5.671259014363718,0.3809767857142857
2020-07-21,32,10,19,61,5642,2028,763,5.699712806832876,0.30744590163934427
2020-07-22,41,9,15,65,6841,2591,1115,5.5995540312983545,0.42656923076923076
2020-07-23,41,6,19,66,5948,2015,1202,5.645917924146093,0.4419363636363636
2020-07-24,33,11,26,70,11055,4398,987,5.6086574806644265,0.26096142857142857
2020-07-25,36,10,16,62,6536,2541,1346,5.638329276291104,0.3912403225806451
2020-07-26,35,12,28,75,7574,3010,1147,5.473221161566113,0.30284133333333335
2020-07-27,50,18,39,107,8026,3035,1641,5.530219840333295,0.24680467289719626
2020-07-28,51,13,31,95,13804,5193,1001,5.495243792661424,0.37031263157894734
2020-07-29,52,13,23,88,14237,5315,1118,5.573454026162903,0.3710056818181818
2020-07-30,38,11,26,75,9763,3706,1019,5.716255698722337,0.34231466666666666
2020-07-31,52,8,22,82,10859,3981,2189,5.680046464104934,0.46112560975609757
2020-08-01,50,9,31,90,10012,3913,1862,5.544190173195794,0.38397333333333333
2020-08-02,50,6,52,108,9801,3942,2005,5.346828497157957,0.3605277777777778
2020-08-03,31,19,28,78,7462,2940,1872,5.452186006421469,0.16825128205128204
2020-08-04,54,13,36,103,12076,4706,1977,5.810987986549795,0.3438
2020-08-05,48,11,32,91,9725,3651,1391,5.65499901075114,0.3590516483516484
2020-08-06,64,20,38,122,13282,5054,2743,5.5735974534434245,0.330955737704918
2020-08-07,50,9,21,80,9067,3533,1253,5.663034191354483,0.44194125
2020-08-08,69,14,28,111,13515,5027,3053,5.604749714085241,0.4142342342342342
2020-08-09,38,13,29,80,12899,4682,1268,5.472235845315517,0.3119725
2020-08-10,53,14,27,94,9977,3859,1732,5.51494252806127,0.37079787234042555
2020-08-11,47,13,35,95,8349,3221,1920,5.663459991999694,0.31122421052631577
2020-08-12,49,6,27,82,7257,2707,1337,5.536604825646097,0.4461
2020-08-13,30,10,26,66,6443,2510,1350,5.681837019860551,0.2646272727272727
2020-08-14,46,13,18,77,9520,3374,1391,5.685058217622585,0.35486883116883117
2020-08-15,43,5,33,81,7636,2885,1603,5.814762247998091,0.43247530864197536
2020-08-16,37,7,17,61,5917,2274,1354,5.712545331632837,0.3787213114754098
2020-08-17,39,15,28,82,10761,4223,1595,5.563593973885489,0.2835439024390244
2020-08-18,58,15,37,110,9968,3812,1838,5.567927303368206,0.3368490909090909
2020-08-19,40,7,29,76,6406,2474,1225,5.46381691686099,0.38099736842105264
2020-08-20,45,6,22,73,8348,3219,1351,5.602651007043483,0.445372602739726
2020-08-21,33,8,23,64,6576,2505,1076,5.647553668009364,0.3362546875
2020-08-22,44,10,18,72,8154,3267,1599,5.571799606540033,0.40544305555555554
2020-08-23,36,3,21,60,8291,3449,1086,5.622938003133961,0.45721
2020-08-24,33,12,26,71,6272,2309,1264,5.651389847021778,0.2901788732394366
2020-08-25,26,13,13,52,5776,2248,1184,5.579540321949098,0.21522884615384616
2020-08-26,30,8,23,61,5399,2054,1037,5.639288292023974,0.32885081967213114
2020-08-27,41,10,26,77,6053,2324,992,6.086378231722927,0.3527935064935065
2020-08-28,39,10,26,75,7928,3122,1023,5.486372922114733,0.3190053333333333
2020-08-29,32,8,18,58,4745,1810,708,5.61706721673981,0.34657241379310344
2020-08-30,20,6,15,41,3911,1498,1302,5.534459160540484,0.3392390243902439
2020-08-31,30,9,26,65,4806,1747,937,5.508110643423798,0.29930769230769233
2020-09-01,36,5,24,65,7509,3015,978,5.508714481466942,0.41766615384615385
2020-09-02,41,10,30,81,7070,2695,1416,5.697483162587838,0.35618765432098765
2020-09-03,40,13,36,89,10582,4196,2197,6.368081580407012,0.23743820224719103
2020-09-04,39,14,38,91,8009,2910,1519,5.53405631092597,0.22433956043956044
2020-09-05,35,12,24,71,6120,2505,1498,5.487144005188381,0.28736901408450705
2020-09-06,31,8,13,52,4927,1864,1012,5.416363728503981,0.4191326923076923
2020-09-07,31,13,18,62,7195,2847,1046,5.675511617104932,0.21871290322580644
2020-09-08,26,7,26,59,4657,1710,898,5.7595170719997695,0.2928661016949152
2020-09-09,35,9,20,64,6728,2541,1165,5.623148702820867,0.3302609375
2020-09-10,21,6,21,48,4458,1643,713,5.667166838037763,0.34579791666666665
2020-09-11,27,11,22,60,6664,2433,877,5.680586144989964,0.19266666666666668
2020-09-12,20,7,17,44,4343,1680,492,5.863032629719775,0.27150227272727273
2020-09-13,27,4,16,47,5098,1788,601,5.6992789716933645,0.4334255319148936
2020-09-14,35,6,18,59,6820,2520,911,5.718511448468926,0.4446084745762712
2020-09-15,26,15,20,61,5349,1936,906,5.503576921434393,0.18425901639344264
2020-09-16,41,11,23,75,7844,2998,908,5.831915098836395,0.360468
2020-09-17,25,5,20,50,4390,1613,617,5.754123007210617,0.38707
2020-09-18,30,10,17,57,6138,2278,1113,5.822994974146103,0.3280543859649123
2020-09-19,22,5,16,43,3770,1383,487,5.8524168765320725,0.32383023255813953
2020-09-20,24,4,18,46,4711,1681,900,5.71850838937466,0.40892173913043484
2020-09-21,25,8,19,52,8569,3342,862,5.635270067934955,0.24955961538461538
2020-09-22,19,5,24,48,5499,1955,804,5.530295245595041,0.21668125000000002
2020-09-23,28,10,24,62,4802,1801,839,5.594814550158039,0.2188435483870968
2020-09-24,19,3,20,42,3979,1498,608,6.69061253236787,0.34403333333333336
2020-09-25,29,12,24,65,14006,5201,1082,5.86006873573603,0.24290461538461539
2020-09-26,18,5,21,44,4763,1814,714,5.439336991199664,0.28758409090909093
2020-09-27,18,4,23,45,4696,1851,1174,5.459250023217191,0.31832
2020-09-28,27,9,20,56,5533,2026,1459,5.642234148722089,0.2806142857142857
2020-09-29,32,5,17,54,5908,2241,771,5.729869944476808,0.45866111111111113
2020-09-30,21,7,18,46,4027,1380,586,5.562605519325379,0.2894652173913044
2020-10-01,30,12,18,60,5514,2082,1039,5.620687482584314,0.29542833333333335
2020-10-02,22,6,23,51,4514,1771,754,5.560817998068992,0.3331960784313725
2020-10-03,22,4,16,42,6242,2458,604,5.940671910793817,0.3914095238095238
2020-10-04,27,5,14,46,6480,2449,961,5.439046727860168,0.4593782608695652
2020-10-05,24,7,15,46,5747,2089,549,5.698542762553075,0.30756304347826086
2020-10-06,31,8,13,52,6014,2349,592,6.21089171562373,0.37714423076923076
2020-10-07,29,9,19,57,5037,1873,1127,5.548006988772955,0.30622105263157895
2020-10-08,24,5,22,51,3976,1469,641,6.228466812293941,0.3084843137254902
2020-10-09,30,5,24,59,5037,1843,710,5.626612115425978,0.3205271186440678
2020-10-10,20,3,21,44,4320,1619,925,5.69092743797535,0.36915681818181817
2020-10-11,17,5,20,42,3580,1361,784,5.6184675580738395,0.26939761904761905
2020-10-12,37,8,21,66,6763,2546,1004,5.558529506049385,0.3943333333333333
2020-10-13,29,8,23,60,5196,1946,824,5.738544163537183,0.29512
2020-10-14,29,9,20,58,7079,2704,1149,5.650690781914066,0.31015862068965516
2020-10-15,32,7,20,59,5194,1948,1087,5.538339276898863,0.38851864406779657
2020-10-16,28,9,16,53,4666,1762,733,5.820468047562213,0.2712811320754717
2020-10-17,29,5,15,49,5217,2031,675,5.663462951006811,0.41541836734693877
2020-10-18,29,7,18,54,9381,3294,1260,5.66418474715953,0.35222037037037035
2020-10-19,36,8,31,75,7234,2697,1323,5.466990956627824,0.35750666666666664
2020-10-20,38,13,32,83,7722,2892,1370,5.655034559382378,0.2697313253012048
2020-10-21,55,15,38,108,8025,3024,2069,5.42085904494362,0.3243916666666667
2020-10-22,51,12,47,110,8111,3099,1337,5.497635680617914,0.3498590909090909
2020-10-23,56,8,29,93,7730,2899,1328,5.641867870763652,0.44378709677419353
2020-10-24,38,6,19,63,5163,1995,1170,5.564403922763505,0.43620158730158726
2020-10-25,40,10,29,79,6549,2536,2137,5.601281027835032,0.3434873417721519
2020-10-26,48,13,32,93,9672,3731,1361,5.693373435732515,0.31904301075268815
2020-10-27,44,17,52,113,10244,3956,2289,5.41834244141456,0.23639380530973453
2020-10-28,49,22,33,104,9603,3796,1493,5.660042988819023,0.20077788461538462
2020-10-29,48,20,35,103,10792,4244,1464,5.504597561663447,0.1870873786407767
2020-10-30,42,13,28,83,11094,4290,1223,5.608709449104427,0.2977542168674699
2020-10-31,49,19,26,94,7896,3059,1581,5.480700425077885,0.25777340425531914
2020-11-01,40,10,41,91,9143,3620,1580,5.480264925442316,0.3243692307692308
2020-11-02,35,14,26,75,7726,2778,1067,5.7549468447401155,0.2539653333333333
2020-11-03,50,10,38,98,8488,3233,1574,5.57265017869782,0.35966224489795917
2020-11-04,52,12,28,92,9165,3395,1330,5.568461360177408,0.38611304347826086
2020-11-05,67,13,53,133,10576,3963,3191,5.320988419000715,0.35514210526315787
2020-11-06,72,19,58,149,15083,5880,2836,5.8353015463496,0.3181362416107383
2020-11-07,46,6,45,97,9665,3834,1964,5.487003326531339,0.3979453608247423
2020-11-08,44,9,24,77,8868,3517,1117,5.482546583452418,0.4020727272727273
2020-11-09,61,11,29,101,8999,3422,1810,5.614749974729171,0.42635643564356435
2020-11-10,33,8,33,74,6072,2328,1080,5.6587793302827984,0.3400594594594595
2020-11-11,59,14,30,103,12698,4951,2860,5.549837915525499,0.3876310679611651
2020-11-12,65,14,47,126,14421,5620,2285,5.517154274738381,0.36984285714285714
2020-11-13,62,8,49,119,11578,4368,2118,5.549085641164524,0.4177159663865546
2020-11-14,49,14,22,85,8869,3272,1712,5.639570742419452,0.38385294117647056
2020-11-15,49,16,41,106,11477,4435,2140,5.667705440236684,0.29871132075471696
2020-11-16,62,13,45,120,13216,5061,2541,5.445751221069619,0.38637916666666666
2020-11-17,95,30,73,198,15762,6033,3184,5.375613039966136,0.30195
2020-11-18,107,37,83,227,21343,8209,5507,5.456555391618489,0.26257665198237884
2020-11-19,97,15,56,168,15179,5728,2853,5.49248433045136,0.4164136904761905
2020-11-20,90,22,59,171,16286,6402,2559,5.418296986402433,0.3532929824561403
2020-11-21,89,19,77,185,17039,6816,3323,5.41740184172798,0.34452540540540544
2020-11-22,77,21,55,153,14469,5633,2800,5.565462328200189,0.3273039215686275
2020-11-23,87,12,58,157,17167,6621,2379,5.751367866322414,0.4403726114649681
2020-11-24,93,20,86,199,18620,7190,3550,5.465805231255525,0.31762964824120604
2020-11-25,95,19,64,178,18196,6925,3490,5.575690496153576,0.37213370786516853
2020-11-26,75,25,63,163,12567,4873,3346,5.473541151990365,0.26867116564417176
2020-11-27,60,17,42,119,10358,3972,2135,5.597878973325743,0.3171831932773109
2020-11-28,47,16,51,114,11504,4394,2460,5.5352568694415565,0.27127894736842106
2020-11-29,77,14,40,131,12394,4841,2910,5.494000825843134,0.42782213740458014
2020-11-30,74,15,54,143,13239,5101,2755,5.566088964128182,0.333213986013986
2020-12-01,92,23,54,169,17319,6810,3110,5.683160303115953,0.35097455621301776
2020-12-02,63,12,55,130,14089,5036,1941,5.6398552844680285,0.33638
2020-12-03,86,15,48,149,13034,5047,2883,5.641974876182413,0.42726912751677854
2020-12-04,58,18,47,123,13006,5147,1689,5.691764011695295,0.3038813008130081
2020-12-05,59,18,32,109,11802,4682,1938,5.590709700239306,0.32091926605504584
2020-12-06,57,8,37,102,9912,3809,2441,5.455020448333297,0.38838725490196074
2020-12-07,67,9,46,122,11622,4451,2622,5.594163468122743,0.4136795081967213
2020-12-08,55,13,47,115,12175,4692,1922,5.568241975485069,0.3519486956521739
2020-12-09,74,12,46,132,13503,5074,3070,5.586689101800559,0.36202348484848484
2020-12-10,54,17,36,107,9418,3381,1707,5.649278894792046,0.31741214953271024
2020-12-11,64,8,50,122,14112,5466,2256,5.577191057623417,0.4444524590163934
2020-12-12,44,17,26,87,8285,3231,1095,5.5620901275961705,0.3052666666666667
2020-12-13,66,10,28,104,9554,3676,2574,5.641172142285157,0.4381605769230769
2020-12-14,63,16,34,113,10458,3859,2077,5.6398018851715666,0.36880530973451325
2020-12-15,70,12,38,120,10266,3777,2365,5.613098876010258,0.4341508333333334
2020-12-16,108,20,64,192,17760,6944,4376,5.496612067023556,0.37993489583333334
2020-12-17,182,36,104,322,30694,12063,5300,5.472486283165699,0.39222049689440996
2020-12-18,101,28,88,217,21137,8238,4052,5.408227493897056,0.3027488479262673
2020-12-19,96,23,57,176,14827,5870,3966,5.439366182417062,0.3735863636363636
2020-12-20,81,16,61,158,12381,4779,2729,5.50854152417254,0.37700316455696203
2020-12-21,100,24,59,183,15658,5849,4930,5.424024757233054,0.35641967213114756
2020-12-22,87,37,71,195,26348,9565,3901,5.5272842635046855,0.24577589743589742
2020-12-23,79,27,65,171,16884,6618,3977,5.538884986769623,0.27397894736842104
2020-12-24,82,15,59,156,14263,5467,4319,5.549486332619547,0.3712121794871795
2020-12-25,89,11,47,147,14532,5501,2544,5.524166742154934,0.447612925170068
2020-12-26,121,35,76,232,21327,8457,5610,5.459166856353094,0.30903232758620686
2020-12-27,94,24,62,180,14201,5487,2893,5.301059995556586,0.32981333333333335
2020-12-28,100,21,60,181,15196,5897,4346,5.493720138668493,0.3882160220994475
2020-12-29,98,25,71,194,21432,8469,4248,5.496545123722292,0.3649231958762887
2020-12-30,149,22,89,260,22630,8858,4457,5.469238388735519,0.4064942307692308
2020-12-31,134,32,75,241,21486,8368,4033,5.432080288551547,0.3753970954356846
2021-01-01,135,23,72,230,28600,11193,6242,5.337277596091988,0.4338960869565217
2021-01-02,204,40,156,400,36938,14623,6537,5.340150246244539,0.3593
2021-01-03,231,48,157,436,40341,15971,8933,5.399775760928719,0.37618417431192663
2021-01-04,170,32,112,314,28738,11302,5544,5.439096894928814,0.4046175159235669
2021-01-05,149,36,107,292,24812,9795,4499,5.470557255080689,0.33866301369863017
2021-01-06,181,43,128,352,37788,14613,7249,5.442887768091286,0.36291761363636366
2021-01-07,264,57,184,505,51423,19935,7619,5.408866189840176,0.3615178217821782
2021-01-08,216,47,161,424,38062,14859,5480,5.412381759104386,0.3539122641509434
2021-01-09,172,51,112,335,31040,12183,5237,5.450942734800816,0.32427223880597017
2021-01-10,178,40,111,329,31983,12685,6199,5.461425141548553,0.3796185410334346
2021-01-11,204,61,145,410,41969,16755,9125,5.400429082205515,0.3143865853658537
2021-01-12,141,46,121,308,30012,11659,5282,5.512995943657111,0.25872370129870126
2021-01-13,149,33,99,281,27200,10774,3727,5.609277745726416,0.36552313167259787
2021-01-14,153,45,94,292,30427,12068,5510,5.557393173966391,0.2992941780821918
2021-01-15,124,34,95,253,24670,9681,3452,5.460816468990728,0.3163549407114625
2021-01-16,103,21,64,188,17611,6871,4047,5.373327746267819,0.40116595744680855
2021-01-17,100,30,61,191,19256,7578,3790,5.457266241051783,0.3108225130890052
2021-01-18,95,20,54,169,16407,6354,2684,5.572770350618542,0.40923017751479285
2021-01-19,95,23,76,194,18398,7029,2871,5.6268635028014415,0.36580927835051547
2021-01-20,113,21,65,199,20741,8381,2603,5.561887163107286,0.3972884422110553
2021-01-21,106,29,85,220,20283,7933,3794,5.591087108963887,0.33331772727272724
2021-01-22,104,44,73,221,19079,7346,4572,5.481515182838354,0.2534226244343891
2021-01-23,79,23,48,150,15429,5876,2712,5.550541709155611,0.348606
2021-01-24,79,23,42,144,14894,6014,2467,5.544088478477612,0.3353736111111111
2021-01-25,74,27,54,155,15626,5897,2187,5.59952614496643,0.2908445161290323
2021-01-26,91,9,41,141,15381,5969,2068,5.5574414016186005,0.47346666666666665
2021-01-27,75,17,61,153,13998,5514,2579,5.492556115713703,0.336837908496732
2021-01-28,89,27,63,179,16500,6541,4315,5.488895657294076,0.31563575418994416
2021-01-29,139,44,135,318,26698,10649,5482,5.449240402768425,0.25643364779874217
2021-01-30,143,29,86,258,24972,9937,5111,5.446243389544106,0.396856976744186
2021-01-31,129,25,87,241,25291,10203,3937,5.453948962643811,0.3974253112033195
2021-02-01,143,35,72,250,24723,9629,4869,5.467141734488062,0.3811356
2021-02-02,160,29,79,268,23305,9018,4243,5.454694588738938,0.4370477611940298
2021-02-03,133,26,101,260,23333,9181,4137,5.888510392542103,0.36447961538461543
2021-02-04,144,26,109,279,26151,10458,3471,5.5209928930755305,0.38212293906810035
2021-02-05,130,27,84,241,27091,10633,3853,5.590079774879091,0.37979917012448133
2021-02-06,136,30,88,254,24765,9968,5017,5.514931782819223,0.3858992125984252
2021-02-07,115,38,92,245,22523,8928,3974,5.544303751166799,0.2807510204081633
2021-02-08,202,37,162,401,33561,13329,5717,5.41394529901634,0.358283042394015
2021-02-09,270,77,211,558,51991,20786,6768,5.395123054560474,0.3099168458781362
2021-02-10,206,64,129,399,40585,15930,6183,5.455045773941891,0.30916791979949876
2021-02-11,219,50,158,427,37793,14686,5866,5.525693419178029,0.35867751756440286
2021-02-12,195,43,108,346,36769,14186,4529,5.478541131699948,0.38344046242774565
2021-02-13,174,38,106,318,30309,11931,5020,5.50112965341338,0.3840374213836478
2021-02-14,202,44,145,391,40274,15724,6392,5.555484776402607,0.3405352941176471
2021-02-15,177,41,119,337,41977,16430,6000,5.460224915215375,0.3667839762611276
2021-02-16,181,46,111,338,37847,14967,5990,5.488632906559625,0.3496591715976331
2021-02-17,209,50,142,401,38461,15051,6340,5.383989285915784,0.35240423940149623
2021-02-18,225,45,168,438,43958,17239,11156,5.457568670770104,0.3797029680365297
2021-02-19,204,46,165,415,38448,14450,6553,5.427933435172311,0.3318033734939759
2021-02-20,248,51,166,465,45043,17671,7467,5.445376867101345,0.37905032258064514
2021-02-21,236,52,128,416,48347,18826,6236,5.448188026025453,0.38455240384615386
2021-02-22,213,47,141,401,36697,14263,5702,5.408914141006753,0.37195012468827926
2021-02-23,206,66,144,416,44383,17569,5174,5.376612370968048,0.2816043269230769
2021-02-24,190,51,118,359,36505,14457,5352,5.415462934126698,0.34855013927576606
2021-02-25,156,36,83,275,28572,10851,4000,5.6425425550741535,0.38284945454545455
2021-02-26,123,37,105,265,23303,9207,4309,5.421673900718713,0.3327256603773585
2021-02-27,124,31,84,239,26976,10618,6577,5.483950365787931,0.33868995815899583
2021-02-28,128,38,122,288,28663,11437,5319,5.405562224024163,0.2960732638888889
2021-03-01,128,28,104,260,27303,10865,4755,5.555716240918394,0.3542319230769231
2021-03-02,116,29,79,224,21391,8342,4457,5.548801791975743,0.3473200892857143
2021-03-03,122,41,89,252,27284,10769,5256,5.569071797198804,0.3120638888888889
2021-03-04,106,28,88,222,21487,8566,4979,5.60358579350462,0.30591351351351354
2021-03-05,111,30,73,214,23779,9427,3129,5.502875819414143,0.34407663551401874
2021-03-06,105,27,45,177,19317,7511,3125,5.528376459113337,0.37937514124293786
2021-03-07,107,18,83,208,19167,7606,4425,5.499449793629285,0.38182403846153845
2021-03-08,138,30,78,246,25185,9847,4759,5.533929412172316,0.3771329268292683
2021-03-09,138,27,91,256,24925,9590,4918,5.553958518042785,0.386035546875
2021-03-10,138,30,82,250,22932,8960,4291,5.455005657875317,0.38178320000000004
2021-03-11,110,29,80,219,21048,8174,4166,5.457046202794633,0.3258789954337899
2021-03-12,127,28,74,229,26880,10817,4696,5.553661213635826,0.39511703056768555
2021-03-13,135,29,130,294,23857,9350,4921,5.470316251409009,0.310571768707483
2021-03-14,137,33,80,250,24760,9763,5273,5.423041063012114,0.3620112
2021-03-15,98,34,80,212,20005,7948,5052,5.494640543550719,0.28013726415094337
2021-03-16,143,26,108,277,24780,9662,5075,5.430662551377858,0.3814187725631769
2021-03-17,128,28,95,251,21412,8323,5104,5.517716256963951,0.35640836653386454
2021-03-18,119,32,99,250,24308,9514,3429,5.575937898372495,0.3167236
2021-03-19,88,22,76,186,16815,6399,3013,5.474872550363447,0.3127424731182796
2021-03-20,84,23,45,152,14495,5618,3406,5.531725846346174,0.36461315789473686
2021-03-21,100,18,55,173,17744,7103,3266,5.4913579531320185,0.40941676300578034
2021-03-22,105,14,66,185,19918,7809,3660,5.543797887666129,0.4255
2021-03-23,85,17,62,164,16469,6458,3129,5.595953314434688,0.3596341463414634
2021-03-24,117,29,89,235,23537,9014,3948,5.508729122352418,0.3438514893617021
2021-03-25,113,27,76,216,23210,9202,5978,5.47737101573782,0.3559347222222222
2021-03-26,102,28,68,198,20955,8174,3295,5.457238366889907,0.34464646464646465
2021-03-27,101,15,43,159,17973,6956,4054,5.492390623692426,0.46654779874213836
2021-03-28,96,21,54,171,17538,6905,3572,5.501870148481579,0.3859076023391813
2021-03-29,81,25,59,165,14525,5762,3168,5.3883649637805435,0.29333878787878787
2021-03-30,98,24,91,213,18710,7226,3303,5.562932996126475,0.31945633802816903
2021-03-31,109,21,80,210,20917,8285,4052,5.463319238274038,0.3686966666666667
2021-04-01,112,33,58,203,22263,8504,5214,5.576726701696017,0.34974285714285713
2021-04-02,113,27,64,204,18851,7253,2943,5.506366371514819,0.36561764705882355
2021-04-03,84,22,60,166,15335,5892,3543,5.498126518734041,0.3199
2021-04-04,77,19,45,141,15519,6083,3173,5.493546004267755,0.3879758865248227
2021-04-05,101,19,65,185,17894,7152,3673,5.567132024022036,0.3859254054054054
2021-04-06,94,23,56,173,16827,6585,3685,5.467954745105445,0.37209132947976875
2021-04-07,71,24,63,158,15071,5686,2939,5.6104658991218885,0.30312594936708864
2021-04-08,85,18,48,151,15406,5953,4793,5.614068071994372,0.3943225165562914
2021-04-09,82,24,54,160,18882,7331,2902,5.640088989548163,0.319358125
2021-04-10,89,18,53,160,15203,5839,3345,5.535704778465594,0.365379375
2021-04-11,62,13,63,138,11633,4555,2382,5.462541198349009,0.3358217391304348
2021-04-12,87,16,57,160,15877,6101,2671,5.648854069919408,0.381246875
2021-04-13,135,31,90,256,24006,9350,4694,5.44245818191592,0.36184375
2021-04-14,129,28,97,254,23185,8924,3699,5.439132715778843,0.3381468503937008
2021-04-15,112,27,84,223,19132,7452,4197,5.572297078428057,0.36048206278026906
2021-04-16,129,17,79,225,23529,9067,3684,5.546575155726227,0.4526084444444444
2021-04-17,130,34,86,250,24219,9418,3123,5.484119095100136,0.33507
2021-04-18,147,61,142,350,30384,10519,7163,5.287570410944552,0.21283514285714286
2021-04-19,138,39,91,268,29989,11700,4512,5.539923760426093,0.3127955223880597
2021-04-20,134,27,103,264,29912,11895,3832,5.542705037120638,0.3678848484848485
2021-04-21,125,45,90,260,28010,10947,3979,5.5467359324043315,0.27849384615384615
2021-04-22,133,35,101,269,26879,10576,5515,5.556186376870578,0.33448252788104094
2021-04-23,171,45,143,359,40737,16301,4915,5.415441268933409,0.31354038997214484
2021-04-24,97,37,71,205,22482,9014,3604,5.491841306629739,0.2824614634146342
2021-04-25,103,30,78,211,22329,8690,5312,5.591643252882493,0.31725829383886256
2021-04-26,151,23,97,271,32233,12490,4286,5.552711776584798,0.4186011070110701
2021-04-27,105,14,74,193,18524,7183,3685,5.5323220312658155,0.39526735751295333
2021-04-28,104,23,86,213,21262,8308,4690,5.5440379782804365,0.3360708920187794
2021-04-29,90,33,73,196,19354,7580,4221,5.508812320209723,0.30532448979591836
2021-04-30,104,18,64,186,20032,7871,3408,5.538234285135475,0.41574731182795693
2021-05-01,79,29,54,162,20150,7686,4382,5.525243223753644,0.30419382716049387
2021-05-02,82,16,60,158,15708,6007,2532,5.562307478527503,0.36525443037974686
2021-05-03,97,31,44,172,18103,6830,4294,5.539267883219904,0.3628732558139535
2021-05-04,107,22,57,186,17232,6641,3192,5.609790072430972,0.397836559139785
2021-05-05,114,19,65,198,35318,14860,2875,5.626121772540256,0.4532530303030303
2021-05-06,101,26,82,209,22211,8707,3370,5.561076429893498,0.32765885167464115
2021-05-07,85,23,73,181,18853,7540,3052,5.5788391228776675,0.31089944751381215
2021-05-08,87,15,53,155,16993,7061,3187,5.546128805696188,0.3810916129032258
2021-05-09,79,28,52,159,17904,6968,2971,5.549916598088604,0.30538176100628933
2021-05-10,93,22,60,175,15641,6127,2563,5.78143000561906,0.3852377142857143
2021-05-11,87,17,62,166,16551,6637,2946,5.6004867678019945,0.37965301204819274
2021-05-12,108,14,59,181,17282,6618,3027,5.537239212691184,0.43630552486187846
2021-05-13,151,57,111,319,30622,12060,4761,5.490822275858253,0.2693288401253918
2021-05-14,97,26,67,190,24952,9792,4846,5.6187795266223866,0.343
2021-05-15,94,24,50,168,19460,7672,4005,5.62848724136005,0.35871071428571427
2021-05-16,78,41,89,208,20841,8505,4739,5.561350294035548,0.1635221153846154
2021-05-17,109,50,98,257,29436,11706,5838,5.587330142371618,0.22884007782101168
2021-05-18,122,39,52,213,25117,10073,4310,5.533673127972053,0.34581643192488265
2021-05-19,235,120,240,595,49916,19665,9982,5.333907251850118,0.18680957983193278
2021-05-20,136,49,111,296,32243,12753,6211,5.554821874197293,0.27266385135135135
2021-05-21,122,41,105,268,25991,10349,5358,5.487983262797007,0.2571567164179105
2021-05-22,109,35,89,233,23355,9183,3940,5.5303392411090355,0.2876549356223176
2021-05-23,105,60,92,257,26850,10525,5671,5.382549054471525,0.15729377431906616
2021-05-24,116,35,78,229,20893,7884,3862,5.4491355876865315,0.3025886462882096
2021-05-25,102,35,64,201,22277,8749,4685,5.62342999108689,0.3019044776119403
2021-05-26,98,18,61,177,17284,6639,3114,5.627663114111854,0.39805819209039545
2021-05-27,98,26,59,183,20207,7829,4518,5.634901252555263,0.3353770491803279
2021-05-28,74,22,53,149,15844,6279,4153,5.71120384952982,0.3361664429530201
2021-05-29,93,18,46,157,18087,7213,3119,5.517029420806657,0.4020248407643312
2021-05-30,64,17,38,119,19141,7706,3342,5.6729112964739965,0.36419999999999997
2021-05-31,69,25,40,134,14678,5888,3183,5.616791552943493,0.2958970149253731
2021-06-01,66,10,39,115,11968,4720,2109,5.78013590007996,0.44332347826086954
2021-06-02,71,11,40,122,11938,4533,2021,5.621836714192842,0.4424860655737705
2021-06-03,80,25,32,137,19250,7285,2746,5.625841569017844,0.37607664233576643
2021-06-04,77,20,34,131,12955,4935,3434,5.7518636440680115,0.38465114503816794
2021-06-05,76,17,40,133,21023,8078,4135,5.544548900635047,0.3669451127819549
2021-06-06,73,22,44,139,17116,6713,3104,5.7061428505447,0.358489928057554
2021-06-07,93,29,48,170,15692,5957,3810,5.646374620372668,0.31335117647058824
2021-06-08,89,51,100,240,23524,8972,5141,5.652792205994369,0.1360375
2021-06-09,104,39,94,237,31626,12585,4083,5.633363612333775,0.2823286919831224
2021-06-10,93,27,64,184,17715,6787,3074,5.6266692753406575,0.3227298913043478
2021-06-11,74,25,55,154,15277,5857,2659,5.671516380135338,0.286075974025974
2021-06-12,80,20,39,139,16020,6013,2348,5.593285988142693,0.3807546762589928
2021-06-13,75,18,43,136,15254,5794,3212,5.653627802848147,0.40270220588235295
2021-06-14,66,27,50,143,14282,5364,2406,5.551167022984138,0.2816916083916084
2021-06-15,53,16,43,112,10263,3904,2085,5.587762698522534,0.29039732142857144
2021-06-16,75,14,43,132,14836,5717,2523,5.725284914105146,0.40510378787878787
2021-06-17,73,13,48,134,13287,5061,4668,5.673129024456611,0.40830447761194033
2021-06-18,60,16,32,108,14155,5487,2058,5.748539774086476,0.42841944444444446
2021-06-19,56,16,23,95,9847,3639,2654,5.648106345728254,0.3776294736842105
2021-06-20,48,17,29,94,10500,4130,2740,5.462788503398158,0.3082968085106383
2021-06-21,89,34,65,188,18817,7051,3313,5.597189300965834,0.2829755319148936
2021-06-22,115,33,78,226,34840,13285,4303,5.599479051774649,0.32589292035398226
2021-06-23,53,25,53,131,15176,5769,2260,5.761678860270662,0.23759236641221373
2021-06-24,65,15,46,126,16009,6096,2384,5.80535498740843,0.33647301587301587
2021-06-25,77,16,40,133,16159,6213,2787,5.63932211258431,0.37953007518796994
2021-06-26,60,16,37,113,13089,4954,2708,5.5438793825562165,0.3635230088495575
2021-06-27,63,17,28,108,14573,5622,2692,5.6555932566988005,0.39014351851851853
2021-06-28,58,17,42,117,12240,4574,3147,5.683636853840871,0.33194444444444443
2021-06-29,60,18,38,116,11783,4535,2760,5.526174562858162,0.32556293103448275
2021-06-30,72,15,30,117,15109,5838,3973,5.661819551749729,0.4267179487179487
2021-07-01,59,18,35,112,10698,4046,4140,5.5244525784646665,0.33211160714285715
2021-07-02,52,20,49,121,12779,4942,2211,5.5652842476167335,0.23043636363636363
2021-07-03,55,12,38,105,13647,5186,1865,5.697712557767657,0.37762476190476185
2021-07-04,52,19,21,92,9495,3689,3056,5.702604241950838,0.32205326086956526
2021-07-05,57,21,42,120,12827,4937,2594,5.681078754147662,0.28405416666666666
2021-07-06,44,7,30,81,11166,3138,1423,5.735942507552438,0.39728641975308643
2021-07-07,56,7,21,84,8425,3178,1603,5.706472485704292,0.5237571428571428
2021-07-08,58,9,37,104,15594,6173,1820,5.721095112058056,0.4083240384615384
2021-07-09,43,15,34,92,10768,4096,1914,5.623113024324603,0.2975445652173913
2021-07-10,44,11,25,80,12230,3504,2873,5.64721574274688,0.3438925
2021-07-11,37,13,29,79,9178,3655,2755,5.644697798984943,0.2803696202531646
2021-07-12,46,7,25,78,10277,4134,2031,5.67836853731994,0.4628679487179488
2021-07-13,36,8,23,67,7141,2771,1807,5.769360779035752,0.4079940298507463
2021-07-14,63,16,27,106,10142,3778,2723,5.648135398879277,0.37940094339622643
2021-07-15,64,12,34,110,11683,4526,3050,5.708559529302466,0.4317990909090909
2021-07-16,48,6,38,92,9922,3744,1668,5.732772914852072,0.4016565217391304
2021-07-17,32,13,24,69,8542,3441,1481,5.7129132054104454,0.2819217391304348
2021-07-18,31,11,19,61,9765,3599,2204,5.741855389063103,0.3073704918032787
2021-07-19,34,8,22,64,6826,2753,1680,5.620281773749434,0.416659375
2021-07-20,62,18,21,101,13287,5299,2928,5.48719335531533,0.4064544554455446
2021-07-21,50,12,44,106,11470,4325,2824,5.627187861640673,0.29184245283018867
2021-07-22,41,9,26,76,7405,2824,1323,5.653971485792477,0.359975
2021-07-23,36,17,25,78,9162,3497,1978,5.510054073202706,0.2565269230769231
2021-07-24,38,9,31,78,8689,3497,2472,5.626166433053336,0.31917564102564105
2021-07-25,39,10,27,76,8507,3310,2127,5.880879666808553,0.32001052631578947
2021-07-26,82,10,37,129,12388,4913,3326,5.490594803617495,0.4600503875968992
2021-07-27,62,23,27,112,13160,4865,3706,5.763593817654263,0.32409464285714285
2021-07-28,55,16,49,120,14928,5686,2426,5.601521287874749,0.29827333333333333
2021-07-29,61,17,35,113,14391,5667,2527,5.550302855332663,0.375958407079646
2021-07-30,52,15,30,97,12381,4819,3251,5.603416463755258,0.3851092783505155
2021-07-31,50,17,25,92,10607,4199,2078,5.658825754334816,0.3557108695652174
2021-08-01,51,17,38,106,11243,4491,2954,5.558829888654286,0.27116415094339624
2021-08-02,55,12,28,95,9951,3731,2028,5.428419988125321,0.4167442105263158
2021-08-03,42,16,37,95,7771,3014,2071,5.612811813937285,0.2651336842105263
2021-08-04,57,13,28,98,12624,4414,2078,5.671120915113186,0.3946061224489796
2021-08-05,56,13,32,101,9804,3782,1789,5.659911129690644,0.3936069306930693
2021-08-06,46,21,33,100,12131,4657,4017,5.687092670627325,0.259993
2021-08-07,41,11,30,82,8224,3319,2481,5.739957108667316,0.36656707317073167
2021-08-08,50,6,28,84,9696,3580,2192,5.630762173899212,0.4358797619047619
2021-08-09,62,18,43,123,12643,4812,2687,5.513202321350038,0.32783983739837397
2021-08-10,49,10,34,93,8227,3228,2650,5.668121234609711,0.40491935483870967
2021-08-11,51,15,45,111,14335,5618,2594,5.651793703850926,0.3290027027027027
2021-08-12,47,15,24,86,9319,3600,2111,5.579961798190068,0.3466476744186046
2021-08-13,46,8,37,91,14355,3704,3070,5.709879657192456,0.3832087912087912
2021-08-14,51,23,38,112,10519,4053,4095,5.493833690653688,0.22958125000000001
2021-08-15,41,10,27,78,11896,4209,2291,5.578957573261135,0.39557820512820513
2021-08-16,51,8,32,91,10434,4131,2579,5.598670800583807,0.43429120879120875
2021-08-17,45,10,25,80,8580,3445,2367,5.637684232474543,0.38116374999999997
2021-08-18,45,16,24,85,8366,3272,2189,5.537616507134271,0.34314941176470587
2021-08-19,59,15,33,107,10573,4112,3205,5.607384451736177,0.36897757009345794
2021-08-20,57,9,36,102,8943,3436,4714,5.479385709880742,0.4047137254901961
2021-08-21,42,10,34,86,7105,2772,2862,5.537333036802821,0.3250360465116279
2021-08-22,36,9,29,74,8865,3434,2360,5.424460619711854,0.3224351351351351
2021-08-23,42,7,29,78,9110,3480,1852,5.558475237735943,0.4044782051282051
2021-08-24,68,11,20,99,12066,4804,2394,5.614030726427845,0.5151747474747475
2021-08-25,56,7,27,90,8987,3562,2183,5.5978666452278985,0.4923644444444445
2021-08-26,49,13,36,98,10095,3955,1854,5.597057099487873,0.35148469387755105
2021-08-27,59,9,41,109,10548,4127,2988,5.537400789001677,0.37546238532110093
2021-08-28,45,12,19,76,12577,5233,2649,5.721026987469835,0.39290394736842105
2021-08-29,46,8,21,75,8496,3275,1881,5.505891893464253,0.42044533333333334
2021-08-30,47,11,31,89,8820,3456,2008,5.597357798254417,0.39614494382022475
2021-08-31,45,6,28,79,9537,3418,2156,6.249413284354277,0.4244493670886076
2021-09-01,45,14,26,85,7528,2759,2617,5.604902916364518,0.38154
2021-09-02,49,8,36,93,8985,3344,3132,5.56004311351631,0.37433010752688173
2021-09-03,59,13,22,94,11524,4358,5301,5.464232554270466,0.42744468085106385
2021-09-04,53,7,29,89,11390,4214,2153,5.50939329327243,0.467491011235955
2021-09-05,48,9,30,87,8012,3131,3792,5.611064551555729,0.3759724137931035
2021-09-06,69,11,47,127,14913,5393,4780,5.40766943640545,0.44219212598425195
2021-09-07,90,27,56,173,18947,7221,4467,5.4968205428264385,0.35278728323699426
2021-09-08,80,16,42,138,17753,6080,2351,5.710273274968393,0.415177536231884
2021-09-09,64,12,42,118,11695,4442,3316,5.6181576246866385,0.38284999999999997
2021-09-10,59,9,36,104,12994,5217,2120,5.517637424567534,0.40252211538461535
2021-09-11,51,17,25,93,11130,4289,3331,5.57151681321155,0.317752688172043
2021-09-12,51,6,22,79,9624,3673,3023,5.628329711554064,0.4928506329113924
2021-09-13,53,11,31,95,12172,4874,2462,5.649962684364124,0.380401052631579
2021-09-14,48,14,48,110,11361,4198,3770,5.640207082868933,0.3255072727272727
2021-09-15,49,14,38,101,7814,2959,3379,5.547857967207364,0.2676722772277228
2021-09-16,52,13,31,96,12631,5025,2205,5.728622131388427,0.3415489583333333
2021-09-17,59,13,31,103,14718,5808,2429,5.567051287943673,0.37595922330097087
2021-09-18,33,15,24,72,11312,4426,2276,5.608801801381447,0.2629916666666667
2021-09-19,36,7,25,68,14127,5495,3450,5.588384410203,0.36713823529411765
2021-09-20,54,19,46,119,12436,4920,4762,5.626034121099809,0.25645714285714283
2021-09-21,70,10,31,111,12036,4564,3655,5.499169536558838,0.4590954954954955
2021-09-22,43,11,27,81,9416,3656,2498,5.457676131418009,0.3796481481481481
2021-09-23,46,23,26,95,10722,4197,2105,5.758865206081847,0.24128947368421053
2021-09-24,59,29,51,139,12147,4580,2601,5.5727786699706865,0.16109928057553957
2021-09-25,37,11,29,77,8906,3531,2510,5.623675173820697,0.2925467532467532
2021-09-26,23,10,25,58,6105,2321,1707,5.599080507882594,0.24668965517241379
2021-09-27,50,10,30,90,10241,3976,2485,5.548485419343025,0.3697566666666667
2021-09-28,49,14,34,97,9756,3646,1876,5.600015037089004,0.36427216494845366
2021-09-29,36,6,30,72,7335,2844,1822,5.641478910612059,0.3297055555555556
2021-09-30,38,11,33,82,8344,3231,2611,5.71343553031807,0.3363890243902439
2021-10-01,46,12,30,88,10323,3925,2891,5.490967658513386,0.38698636363636363
2021-10-02,33,8,21,62,5637,2131,1969,5.648620989623767,0.39685161290322585
2021-10-03,49,12,24,85,12711,3731,1576,5.553248651917251,0.3317364705882353
2021-10-04,43,6,28,77,8620,3184,2971,5.688268856343272,0.4284428571428571
2021-10-05,47,12,35,94,9986,3922,3270,5.625321617794027,0.33177340425531915
2021-10-06,57,17,31,105,12527,4797,3463,5.492395095999917,0.3429752380952381
2021-10-07,60,7,37,104,9671,3832,2122,5.543420385263084,0.43605673076923074
2021-10-08,60,8,31,99,12300,4685,2221,5.671586789372096,0.4426464646464647
2021-10-09,38,10,31,79,9498,3657,2805,5.676578900155014,0.3722632911392405
2021-10-10,43,12,20,75,8668,3326,3434,5.54947354479473,0.34610266666666667
2021-10-11,66,10,39,115,11913,4678,2967,5.474534438021316,0.4216965217391304
2021-10-12,63,10,25,98,9735,3660,2781,5.656049505086659,0.45950408163265305
2021-10-13,44,7,40,91,7242,2825,2271,5.578147927635603,0.340289010989011
2021-10-14,65,10,37,112,11582,4548,3837,5.6314320610561905,0.44775892857142857
2021-10-15,68,17,45,130,13709,5492,3302,5.475739449663162,0.3347553846153846
2021-10-16,63,12,44,119,11294,4404,3112,5.562198486306832,0.39782773109243696
2021-10-17,53,16,31,100,13428,5232,3830,5.562314230816139,0.34198
2021-10-18,68,15,37,120,12141,4778,4392,5.66126988674668,0.4030375
2021-10-19,58,13,54,125,11324,4362,6400,5.498930932439226,0.3373224
2021-10-20,68,16,61,145,16158,6317,4201,5.475331331932962,0.31285172413793105
2021-10-21,86,16,59,161,16891,6616,3824,5.575313716781913,0.40113602484472044
2021-10-22,59,14,32,105,10370,4088,3397,5.558372430541094,0.4007866666666667
2021-10-23,44,12,23,79,7307,2892,2555,5.582174009872142,0.4122759493670886
2021-10-24,43,10,28,81,10796,4262,2971,5.546819105365454,0.3622876543209877
2021-10-25,49,12,24,85,8923,3578,2253,5.490514494397148,0.37897882352941176
2021-10-26,67,12,47,126,13323,5248,4372,5.596767260686112,0.3799484126984127
2021-10-27,66,12,38,116,10976,4291,4372,5.4751853310646545,0.4112008620689655
2021-10-28,75,11,33,119,15787,6117,3343,5.533312731713707,0.4695747899159664
2021-10-29,67,12,39,118,11204,4356,4819,5.4781148652912615,0.43202881355932204
2021-10-30,48,14,26,88,9172,3585,2776,5.563260420243251,0.3268170454545455
2021-10-31,53,6,23,82,9681,3683,2865,5.572391848043045,0.5120987804878049
2021-11-01,68,11,44,123,13209,5112,3913,5.637522060860364,0.39524634146341464
2021-11-02,65,22,27,114,10235,3876,3006,5.569651647043735,0.34320350877192984
2021-11-03,61,14,33,108,12217,4907,3670,5.563507417939101,0.3844611111111111
2021-11-04,61,12,32,105,10786,4278,4508,5.600429905473935,0.3623295238095238
2021-11-05,54,10,27,91,10138,4013,2957,5.443543657535223,0.4391153846153846
2021-11-06,45,9,27,81,9719,3728,2549,5.68309434863078,0.4075395061728395
2021-11-07,55,8,35,98,9518,3739,3557,5.594956158110051,0.40341938775510205
2021-11-08,75,9,40,124,13595,5306,5073,5.515958488737836,0.47223629032258063
2021-11-09,93,21,46,160,16284,6363,3862,5.417355921458391,0.395779375
2021-11-10,66,6,51,123,14579,5678,4743,5.554010890448527,0.43407967479674797
2021-11-11,68,18,46,132,11684,4690,4810,5.425485978964621,0.3280340909090909
2021-11-12,67,8,34,109,11821,4715,4233,5.547010182229063,0.4829137614678899
2021-11-13,60,13,32,105,11877,4551,5002,5.571258848793183,0.40597619047619043
2021-11-14,61,10,33,104,12630,4708,4551,5.594465649699691,0.4137692307692308
2021-11-15,53,10,41,104,11973,4612,5026,5.555442403104643,0.3371375
2021-11-16,63,4,42,109,11039,4135,3441,5.470085654977973,0.45701284403669723
2021-11-17,45,15,33,93,11576,4450,3676,5.473926710979322,0.27159462365591397
2021-11-18,71,18,36,125,15749,6182,5770,5.658857293829648,0.4030408
2021-11-19,57,17,37,111,11631,4486,2747,5.597141932926165,0.31821531531531533
2021-11-20,37,14,20,71,9624,3842,4118,5.445046939787034,0.32375211267605636
2021-11-21,49,8,22,79,10282,3931,2797,5.606094088339705,0.4062075949367089
2021-11-22,57,11,30,98,12863,5183,2830,5.6597860722792035,0.40144897959183673
2021-11-23,43,18,38,99,9445,3664,3834,5.571296824583392,0.26045656565656566
2021-11-24,50,14,37,101,15656,6162,2448,5.595068271072449,0.33081089108910894
2021-11-25,63,9,41,113,11273,4411,3424,5.542882511084254,0.44475132743362833
2021-11-26,53,20,31,104,11673,4481,3087,5.680146197651791,0.26962884615384614
2021-11-27,63,8,21,92,11261,3730,3212,5.592013296342574,0.521425
2021-11-28,71,10,33,114,18115,6959,3634,5.519127480539234,0.45425614035087725
2021-11-29,62,12,27,101,10757,4147,3161,5.708560387694984,0.4004079207920792
2021-11-30,57,11,47,115,13299,5014,5366,5.591316636029277,0.36041304347826086
2021-12-01,67,9,34,110,9537,3614,5154,5.552821767506024,0.45537909090909096
2021-12-02,66,10,27,103,13344,5291,4942,5.477396319960224,0.4794864077669903
2021-12-03,40,16,30,86,10237,3979,4648,5.536879524755844,0.2503767441860465
2021-12-04,65,26,47,138,15442,6033,5123,5.4799847962356765,0.27897101449275363
2021-12-05,56,17,41,114,15696,6032,4736,5.62559337748244,0.32665438596491225
2021-12-06,54,17,39,110,11470,4520,3588,5.472329464670047,0.31897000000000003
2021-12-07,71,11,36,118,12780,5078,3002,5.580207417212228,0.42741525423728816
2021-12-08,61,16,37,114,13792,5383,4923,5.539792004874847,0.3240868421052632
2021-12-09,44,11,28,83,9590,3688,3597,5.610721458411327,0.35991084337349394
2021-12-10,49,13,36,98,10357,4123,4940,5.650096039414588,0.337080612244898
2021-12-11,37,16,29,82,8892,3407,3852,5.634079644898638,0.2515512195121951
2021-12-12,34,7,20,61,10742,4308,2895,5.709740560005913,0.38973278688524593
2021-12-13,58,19,31,108,13592,5326,5657,5.661607283939132,0.30878888888888884
2021-12-14,64,12,24,100,9637,3759,4464,5.527919373637157,0.443285
2021-12-15,44,19,34,97,9806,3867,5084,5.668611512308536,0.2033783505154639
2021-12-16,47,9,30,86,8451,3285,4770,5.6681349395915195,0.4126302325581396
2021-12-17,42,15,35,92,10084,3913,4854,5.56032792433071,0.300625
2021-12-18,36,5,24,65,6180,2391,4426,5.569205551007668,0.38203384615384617
2021-12-19,43,10,26,79,10448,4129,4548,5.602705510474797,0.3745417721518987
2021-12-20,47,12,20,79,12450,5003,4244,5.6004827527169745,0.38373037974683544
2021-12-21,51,8,23,82,11332,4213,3362,5.573414837233266,0.4945243902439025
2021-12-22,52,18,20,90,11926,4659,2927,5.724162910821477,0.33161555555555555
2021-12-23,50,6,22,78,10622,4005,4739,5.638264440429771,0.5046666666666666
2021-12-24,48,7,20,75,9731,3411,6026,5.521611244605382,0.4633866666666666
2021-12-25,45,5,19,69,6733,2596,5138,5.632749929471219,0.5178898550724638
2021-12-26,48,2,15,65,7437,2865,4385,5.665384358558686,0.633963076923077
2021-12-27,55,12,23,90,10773,4246,4556,5.469257545294927,0.41642444444444443
2021-12-28,42,13,33,88,10343,4116,4730,5.5529698784030455,0.2919318181818182
2021-12-29,50,4,20,74,10065,3949,4783,5.483341585858992,0.5014837837837838
2021-12-30,51,9,29,89,13272,5199,3830,5.729247193599107,0.42670449438202246
2021-12-31,40,10,21,71,7847,3001,3824,5.795544047974736,0.3685985915492958
2022-01-01,40,10,21,71,7628,3018,7782,5.443135128012149,0.3720056338028169
2022-01-02,34,10,26,70,8501,3226,3738,5.627237546459875,0.3746457142857143
2022-01-03,60,13,23,96,11417,4498,5290,5.619036855463168,0.4248010416666667
2022-01-04,46,8,29,83,9083,3502,4849,5.606973414566762,0.39697469879518077
2022-01-05,66,11,33,110,10862,4382,6430,5.487420707289088,0.42841545454545454
2022-01-06,57,29,49,135,14252,5562,5087,5.553738311484593,0.16784
2022-01-07,60,24,43,127,21512,7381,7067,5.529855484899089,0.2504866141732283
2022-01-08,40,20,43,103,11517,4476,6702,5.422377693564404,0.18271359223300973
2022-01-09,58,10,26,94,9445,3730,6112,5.511092088885047,0.4189063829787234
2022-01-10,49,8,27,84,7867,2968,4959,5.631275492198266,0.40783690476190476
2022-01-11,45,5,35,85,9155,3520,4274,5.58904183651072,0.40364000000000005
2022-01-12,53,10,34,97,11558,4531,5904,5.487761893057726,0.3960494845360825
2022-01-13,48,6,24,78,7823,2947,2655,5.595259285883361,0.4736205128205128
2022-01-14,43,9,26,78,6811,2643,3607,5.577374410964851,0.3924692307692308
2022-01-15,40,10,22,72,7307,2874,4810,5.575429049855051,0.38285694444444446
2022-01-16,40,5,21,66,7295,2809,3766,5.557444005849292,0.43923939393939393
2022-01-17,43,14,15,72,6975,2613,3566,5.578986064726045,0.3258
2022-01-18,36,6,22,64,5767,2239,2202,5.702501435415329,0.4538625
2022-01-19,39,8,33,80,7414,2907,4267,5.716662900249804,0.39663
2022-01-20,48,9,23,80,12199,4707,3630,5.597528029933491,0.41307375
2022-01-21,68,16,50,134,13647,4789,6983,5.490143288490457,0.34431417910447765
2022-01-22,71,22,54,147,13247,5194,4220,5.35324386901933,0.25788707482993195
2022-01-23,51,15,36,102,13503,5358,3944,5.533052870422549,0.31773823529411765
2022-01-24,61,16,28,105,11601,4558,4119,5.528753478192759,0.3743466666666666
2022-01-25,55,12,36,103,12128,4732,4479,5.550006827206075,0.37089708737864074
2022-01-26,70,8,30,108,17964,7067,4650,5.654298973917588,0.5243805555555555
2022-01-27,48,16,15,79,8714,3453,3887,5.594219821597162,0.3740278481012658
2022-01-28,41,8,33,82,8351,3276,2954,5.774633566752416,0.3635268292682927
2022-01-29,33,9,30,72,7295,2906,3315,5.635279329106464,0.3229527777777778
2022-01-30,40,9,25,74,11110,4452,2651,5.637264773776783,0.3350283783783784
2022-01-31,41,7,21,69,11696,4433,3466,5.621646181783008,0.4337376811594203
2022-02-01,49,14,33,96,9274,3635,4758,5.551182387562094,0.33198541666666664
2022-02-02,40,4,31,75,9614,3664,2270,5.493644623945564,0.42892800000000003
2022-02-03,37,15,17,69,6633,2468,1989,5.51115410911226,0.30269710144927536
2022-02-04,43,12,30,85,8126,3028,3321,5.609128135093094,0.31876823529411763
2022-02-05,32,13,22,67,9006,3397,2015,5.772479922108734,0.3046402985074627
2022-02-06,39,12,28,79,9391,3642,3071,5.6088903938130565,0.2973151898734177
2022-02-07,44,9,40,93,10999,4389,2388,5.4920893738722265,0.37361075268817207
2022-02-08,40,15,27,82,10612,3927,2629,5.561248472127441,0.27595243902439026
2022-02-09,34,9,29,72,5625,2249,2210,5.528727722651663,0.3222388888888889
2022-02-10,55,7,31,93,10040,3896,2470,5.726564122411215,0.44343333333333335
2022-02-11,44,12,18,74,7833,3039,2771,5.5839658733421125,0.38263783783783784
2022-02-12,31,9,12,52,7107,2808,1894,5.720288963733211,0.3944326923076923
2022-02-13,37,10,21,68,6916,2492,1997,5.6042609461457635,0.3678617647058824
2022-02-14,41,6,21,68,6183,2437,1830,5.592323152861537,0.47005882352941175
2022-02-15,37,14,27,78,8135,3173,3349,5.600590827023017,0.2875615384615385
2022-02-16,42,12,26,80,7819,2953,1499,5.650809778603004,0.33340000000000003
2022-02-17,42,11,24,77,9235,3592,2153,5.875768473533882,0.38944805194805193
2022-02-18,43,8,31,82,7937,3067,1489,5.668749037216526,0.374559756097561
2022-02-19,44,10,23,77,7818,2931,2357,5.7195467751385705,0.4064194805194805
2022-02-20,43,9,29,81,9859,3853,2937,5.447732057381965,0.3665728395061728
2022-02-21,46,13,25,84,9232,3600,1660,5.601142083173842,0.3603309523809524
2022-02-22,28,13,28,69,6567,2683,1817,5.58507185734693,0.2602304347826087
2022-02-23,38,6,25,69,8197,3177,2708,5.6385166035692,0.40227246376811593
2022-02-24,48,19,25,92,12812,4413,3013,5.65696427160437,0.2987032608695652
2022-02-25,30,5,23,58,6248,2452,934,5.595961251559062,0.4136
2022-02-26,29,8,15,52,5861,2262,1478,5.790065545392058,0.35996730769230767
2022-02-27,30,6,12,48,9184,3549,1548,5.677735959451893,0.43534791666666667
2022-02-28,41,13,33,87,10879,4331,3018,5.686742762624924,0.27701954022988506
2022-03-01,44,11,28,83,7447,2791,2491,5.430175583523443,0.3726349397590361
2022-03-02,44,11,24,79,9297,3626,2359,5.610946327387712,0.34931392405063294
2022-03-03,27,8,21,56,6593,2574,1088,5.660324517464069,0.28854107142857144
2022-03-04,32,7,16,55,7144,2861,1751,5.6285867792133075,0.3887145454545455
2022-03-05,22,8,15,45,3933,1432,1583,5.434557460247281,0.2676866666666667
2022-03-06,32,5,24,61,7252,2734,1702,5.488791662039562,0.3912606557377049
2022-03-07,26,7,22,55,5082,1993,2366,5.776577054261491,0.32360000000000005
2022-03-08,38,10,22,70,8531,3386,2151,5.570688442450191,0.35282428571428576
2022-03-09,35,11,18,64,14379,5908,1721,5.670302719691313,0.362940625
2022-03-10,42,9,21,72,7027,2713,1465,5.532626887299162,0.4403138888888889
2022-03-11,21,10,19,50,10489,2000,1390,5.670556697356131,0.195364
2022-03-12,28,9,17,54,6440,1954,1302,5.409260929072218,0.29131666666666667
2022-03-13,29,8,15,52,6141,2290,1449,6.205142045402253,0.3307307692307692
2022-03-14,36,10,16,62,7012,2222,1566,5.803393715842417,0.34813064516129033
2022-03-15,27,3,20,50,4498,1674,1308,5.664828650416542,0.409966
2022-03-16,38,4,24,66,6061,2301,1363,5.558570539436331,0.4360681818181818
2022-03-17,39,5,25,69,9949,2834,2102,5.89811971147585,0.4488768115942029
2022-03-18,23,7,25,55,7292,2915,1297,5.60553080215289,0.2849654545454545
2022-03-19,22,11,23,56,5763,2302,1389,5.703950544540575,0.16366071428571427
2022-03-20,37,7,19,63,6508,2514,2000,5.6314982110471785,0.44619841269841265
2022-03-21,49,3,28,80,6854,2666,1543,5.439376349939891,0.456565
2022-03-22,39,8,18,65,9402,3836,1200,5.602889518121602,0.36870769230769235
2022-03-23,29,8,16,53,4165,1603,1323,5.583241112289741,0.34778113207547173
2022-03-24,38,5,17,60,7302,2834,1811,5.72578342608026,0.49010499999999996
2022-03-25,34,2,22,58,6320,2399,1656,5.73109653270326,0.5071362068965517
2022-03-26,29,7,18,54,6390,2483,2170,5.627513639460134,0.3647333333333333
2022-03-27,30,7,16,53,5836,2292,1836,5.58482188027446,0.36890377358490567
2022-03-28,33,8,25,66,7233,2722,1148,5.49924225724677,0.30966969696969693
2022-03-29,35,4,15,54,6421,2561,1499,5.7249716746496455,0.5349851851851852
2022-03-30,31,6,19,56,4939,1872,1285,5.520242663462967,0.3899392857142857
2022-03-31,41,5,27,73,9157,3518,1929,5.786446181897124,0.47860547945205484
2022-04-01,46,6,19,71,6434,2415,2327,5.451012593123237,0.4831605633802817
2022-04-02,25,2,29,56,6878,2690,2170,5.620535571482433,0.3890535714285714
2022-04-03,34,8,23,65,7470,2926,2515,5.679958593970845,0.33751846153846154
2022-04-04,38,7,21,66,7306,2879,1682,5.664979449657835,0.4449242424242424
2022-04-05,38,5,22,65,7919,3199,1305,5.693579040089389,0.4106415384615385
2022-04-06,40,9,20,69,6812,2589,1980,5.721971577487702,0.38176666666666664
2022-04-07,37,8,34,79,8008,3004,3078,5.686665445633945,0.3844367088607595
2022-04-08,41,9,37,87,8656,3354,2742,5.622914240280757,0.3258264367816092
2022-04-09,40,8,16,64,7593,2973,2957,5.674854307483483,0.4733515625
2022-04-10,38,4,15,57,10762,4376,2441,5.555525843910313,0.5510929824561404
2022-04-11,43,9,22,74,8340,3308,2212,5.5118770419763345,0.3656364864864865
2022-04-12,41,6,23,70,6669,2499,2176,5.563846927012638,0.45947142857142864
2022-04-13,29,9,29,67,6946,2730,1790,5.575526388976254,0.24049850746268656
2022-04-14,46,10,26,82,10712,4192,2064,5.515568105796843,0.41755000000000003
2022-04-15,32,8,20,60,9025,3484,1858,5.694423615806594,0.3771833333333333
2022-04-16,31,8,13,52,5492,2157,2293,5.700261785783349,0.3540076923076923
2022-04-17,33,5,17,55,6407,2536,1749,5.614340434183704,0.47175272727272727
2022-04-18,19,13,14,46,5725,2327,1514,5.549263920860547,0.1292217391304348
2022-04-19,37,3,18,58,5775,2286,1753,5.787204644400608,0.5660827586206897
2022-04-20,27,9,22,58,4895,1876,2155,5.545763627007839,0.2842689655172414
2022-04-21,35,7,17,59,8419,3167,2593,5.644422088909819,0.4654169491525424
2022-04-22,30,8,22,60,6297,2396,1698,5.749668018338165,0.32383999999999996
2022-04-23,23,3,15,41,5071,2027,1345,5.732299653914688,0.4606609756097561
2022-04-24,26,7,17,50,5571,2163,1993,5.5260382317022865,0.37479599999999996
2022-04-25,30,11,18,59,7427,2888,2025,5.712197963330813,0.2955101694915254
2022-04-26,21,5,9,35,3898,1564,1272,5.565431005804841,0.3794742857142857
2022-04-27,28,7,20,55,6325,2410,1307,5.749390034755954,0.3552618181818182
2022-04-28,46,7,13,66,9200,3592,1848,5.711014901285006,0.4995454545454545
2022-04-29,28,6,24,58,7553,2881,1455,5.846748785769597,0.3375241379310345
2022-04-30,19,4,13,36,6428,2491,629,5.566747662321875,0.35268333333333335
2022-05-01,32,13,21,66,5779,2193,3488,5.641784319285261,0.2653833333333333
2022-05-02,29,9,18,56,6052,2215,2703,5.567686033902956,0.34311428571428576
2022-05-03,28,9,17,54,5398,2138,1627,5.705473622975235,0.2849185185185185
2022-05-04,35,6,15,56,15600,5724,1901,5.692383582790393,0.4360178571428572
2022-05-05,37,7,19,63,7502,2930,1856,5.776528958673999,0.3972603174603175
2022-05-06,34,4,15,53,5366,2071,1429,5.639092544014063,0.5074735849056604
2022-05-07,27,5,23,55,5355,2086,1227,5.413208299492383,0.31051090909090906
2022-05-08,34,2,22,58,8296,3323,2338,5.4912561616528,0.5189103448275862
2022-05-09,42,9,28,79,7592,2849,3348,5.40216318905952,0.36055569620253164
2022-05-10,32,19,27,78,5902,2305,2052,5.3847525357369665,0.16603461538461536
2022-05-11,56,14,27,97,10527,4055,3750,5.532155265359276,0.38104329896907213
2022-05-12,57,23,55,135,11175,4463,3939,5.481465576582671,0.24961481481481482
2022-05-13,57,17,33,107,11914,4735,2862,5.6119384334461655,0.30371588785046727
2022-05-14,39,13,18,70,6906,2747,3466,5.667993305360661,0.30106428571428573
2022-05-15,28,18,23,69,7888,3172,2681,5.506315025401888,0.10275217391304348
2022-05-16,40,8,31,79,6824,2697,2366,6.031871621364328,0.3796
2022-05-17,43,3,21,67,8732,3501,1962,5.633184864718124,0.5387940298507463
2022-05-18,34,12,27,73,7627,2972,2039,5.859414796265274,0.24912191780821918
2022-05-19,45,10,16,71,6894,2746,2821,5.57971633068348,0.4245943661971831
2022-05-20,26,11,21,58,6245,2426,1828,5.573695685861083,0.24514827586206897
2022-05-21,27,7,18,52,7533,3050,2339,5.554688826853491,0.3674519230769231
2022-05-22,27,6,23,56,4827,1882,1383,5.597907236475784,0.3725428571428572
2022-05-23,28,9,16,53,5502,2138,2342,5.6013769535052305,0.34279622641509433
2022-05-24,39,10,20,69,7401,2923,2507,5.542994399012787,0.35257101449275363
2022-05-25,27,8,23,58,7451,2839,3471,5.615287369055501,0.34002241379310344
2022-05-26,28,5,28,61,6585,2512,1185,5.5252094426982605,0.3250131147540984
2022-05-27,28,10,18,56,6541,2436,1969,5.480370236157245,0.33222321428571433
2022-05-28,20,3,22,45,5017,1983,1060,5.660251132540204,0.37967555555555554
2022-05-29,23,10,23,56,4735,1870,2009,5.641308522100128,0.24670357142857144
2022-05-30,19,5,10,34,2996,1142,807,5.679302492424422,0.3442558823529412
2022-05-31,22,6,19,47,3194,1243,1253,5.5380498206239235,0.2980659574468085
2022-06-01,19,5,15,39,5191,2042,1781,5.5661985777016065,0.39936153846153843
2022-06-02,24,6,12,42,3559,1346,1258,5.447246818723787,0.40459523809523806
2022-06-03,31,5,18,54,4622,1655,1263,5.644812204397717,0.3773944444444445
2022-06-04,21,6,19,46,4476,1765,1439,5.581474501011955,0.3245695652173913
2022-06-05,29,7,15,51,4972,1882,1429,5.541675508369869,0.3483176470588235
2022-06-06,41,9,18,68,6384,2520,2618,5.606761291036392,0.41862794117647056
2022-06-07,37,7,24,68,8185,3169,2015,5.533065139957767,0.37814852941176474
2022-06-08,24,12,9,45,4255,1588,1349,5.578389127119893,0.2486888888888889
2022-06-09,30,8,13,51,7092,2760,1339,5.5308903254180155,0.3849254901960784
2022-06-10,30,7,14,51,5586,2187,2092,5.564240808683299,0.3935921568627451
2022-06-11,19,13,12,44,4605,1789,1830,5.581958840035657,0.11753409090909091
2022-06-12,19,4,11,34,3466,1354,835,5.528628239488675,0.45292941176470586
2022-06-13,59,19,61,139,15291,6010,4656,5.405769493171615,0.2572863309352518
2022-06-14,67,22,52,141,13298,5251,3636,5.461808031564618,0.30366028368794323
2022-06-15,64,18,39,121,13667,5089,6867,5.500434921956216,0.3318504132231405
2022-06-16,41,15,24,80,9340,3745,2430,5.433585515298809,0.26652375
2022-06-17,39,21,27,87,9231,3578,3420,5.587053940421124,0.1900551724137931
2022-06-18,60,28,53,141,15406,6105,5202,5.432622179097847,0.19290070921985816
2022-06-19,63,16,39,118,13271,5326,3674,5.476906068688734,0.3524906779661017
2022-06-20,34,9,23,66,7168,2778,2480,5.6604305747734065,0.3209227272727273
2022-06-21,44,11,22,77,8843,3497,1951,5.704451336967087,0.3548831168831169
2022-06-22,43,14,27,84,9777,3889,2340,5.706934049727488,0.2858690476190476
2022-06-23,44,9,20,73,6838,2691,1752,5.5963357568240175,0.4090054794520548
2022-06-24,26,10,15,51,6958,2849,2438,5.447060088741321,0.26196274509803924
2022-06-25,21,6,17,44,4013,1588,1295,5.678930855924732,0.30932954545454544
2022-06-26,30,6,21,57,6957,2712,2212,5.593384277854285,0.3807035087719298
2022-06-27,41,8,21,70,7822,3084,1794,5.599539728026206,0.39836
2022-06-28,31,10,18,59,6640,2747,1735,5.467047036328401,0.31986610169491525
2022-06-29,26,5,22,53,5571,2076,2522,5.674615733847341,0.3624471698113208
2022-06-30,42,8,25,75,8218,3295,3315,5.727818177642122,0.3365226666666667
2022-07-01,31,11,22,64,6007,2363,2214,5.451498604546946,0.30666875
2022-07-02,33,8,21,62,7612,3016,1858,5.708672856892949,0.3801629032258064
2022-07-03,27,4,20,51,5300,2084,1506,5.56968565069985,0.3341
2022-07-04,29,7,22,58,5570,2147,1971,5.709964943201515,0.3457741379310345
2022-07-05,26,6,29,61,4921,1914,1710,5.439540642684663,0.25907377049180325
2022-07-06,23,3,27,53,6092,2404,1195,5.485134256382258,0.32492264150943395
2022-07-07,34,9,15,58,7715,3124,1767,5.634891728331418,0.4077448275862069
2022-07-08,31,13,18,62,9005,3500,2276,5.6820729163565655,0.2589048387096774
2022-07-09,17,6,17,40,2961,1206,1818,5.50325946944581,0.2504625
2022-07-10,14,6,10,30,2932,1124,1361,5.5521506901660675,0.20918666666666666
2022-07-11,23,6,13,42,3887,1471,1309,5.570513463003875,0.3576095238095238
2022-07-12,38,7,31,76,5690,2136,2975,5.585430535261279,0.39113947368421054
2022-07-13,18,11,22,51,4597,1721,1217,5.401884791518867,0.14446078431372547
2022-07-14,33,11,10,54,7505,2926,3339,5.798383069571396,0.38250370370370373
2022-07-15,21,9,26,56,6327,2332,1458,5.57112533160646,0.18878035714285715
2022-07-16,27,6,17,50,5935,2333,1866,5.633631743510346,0.34719
2022-07-17,20,7,18,45,4093,1582,2252,5.410209280846023,0.28176444444444443
2022-07-18,20,7,13,40,5273,2109,1579,5.672277861077372,0.310995
2022-07-19,27,7,21,55,5034,2073,2263,5.55610623042954,0.3150727272727273
2022-07-20,30,6,20,56,5213,2002,966,5.774432249705973,0.31167678571428575
2022-07-21,24,9,23,56,7047,2757,1241,5.742110571584483,0.2889
2022-07-22,21,4,21,46,3914,1463,1088,5.688599126734482,0.32828913043478264
2022-07-23,14,7,10,31,2747,1110,823,5.77663836953212,0.1786258064516129
2022-07-24,15,3,15,33,2819,1084,1770,5.787804939702745,0.36719999999999997
2022-07-25,21,5,25,51,4498,1636,939,5.677644418355335,0.33848235294117646
2022-07-26,26,8,18,52,7378,2857,1450,5.576323807601986,0.331425
2022-07-27,26,7,18,51,7783,3021,1055,5.787372001852785,0.3106607843137255
2022-07-28,36,4,22,62,7684,2969,1181,5.779091421869892,0.443391935483871
2022-07-29,25,2,22,49,5238,2032,1565,6.073839680573461,0.41844285714285717
2022-07-30,23,11,18,52,5767,2283,1046,5.479844034472003,0.23811923076923078
2022-07-31,20,3,13,36,3280,1252,1031,5.659760423767343,0.44133055555555556
2022-08-01,32,11,9,52,10665,4067,1443,5.602040925695243,0.332675
2022-08-02,23,3,11,37,4057,1582,1414,5.390662487295703,0.5274216216216217
2022-08-03,29,3,15,47,4278,1659,741,5.8569332733247625,0.48023191489361705
2022-08-04,30,3,15,48,5118,1921,1296,5.730224416432889,0.4780125
2022-08-05,28,7,14,49,5814,2193,1946,5.744090072634291,0.40197959183673465
2022-08-06,22,5,13,40,3658,1397,1584,5.772853704388865,0.3660025
2022-08-07,16,3,8,27,2160,797,787,5.420918910154626,0.4000074074074074
2022-08-08,24,7,14,45,4997,1966,1855,5.686117449418977,0.34432
2022-08-09,17,5,16,38,3637,1385,1346,5.815602693340327,0.31182105263157894
2022-08-10,25,3,15,43,4495,1681,1144,5.806584604818055,0.40103720930232556
2022-08-11,30,4,17,51,4520,1734,1573,5.518872059327804,0.4415588235294118
2022-08-12,18,6,10,34,4886,1916,1407,5.727526098064106,0.3713970588235294
2022-08-13,18,3,11,32,2372,948,1764,5.515742683792513,0.36071875
2022-08-14,24,3,11,38,3739,1449,1025,5.680014487983884,0.45695526315789475
2022-08-15,25,1,16,42,3910,1608,1079,5.688946908951222,0.4666595238095238
2022-08-16,20,4,17,41,3561,1395,1266,5.529352286389844,0.3422804878048781
2022-08-17,19,9,18,46,3890,1572,849,5.786744645079591,0.2523565217391304
2022-08-18,28,5,14,47,4437,1705,1563,5.656123222578551,0.4884042553191489
2022-08-19,11,4,12,27,1881,750,1008,5.76243576392676,0.15182962962962965
2022-08-20,13,3,14,30,3984,1656,702,5.74557687527952,0.32026333333333334
2022-08-21,26,1,12,39,2613,971,985,5.47333804060619,0.5068615384615385
2022-08-22,21,5,12,38,3366,1340,1490,5.6724278760379985,0.40875263157894737
2022-08-23,25,11,16,52,4512,1684,1805,5.718651683173864,0.2548423076923077
2022-08-24,18,4,13,35,3768,1528,2486,5.771696972888128,0.32779142857142857
2022-08-25,21,4,10,35,3327,1235,1104,5.897577563587748,0.38516
2022-08-26,22,3,9,34,5167,2039,1247,5.560831759783604,0.48993235294117654
2022-08-27,20,2,9,31,2500,961,855,5.623202653578877,0.4911935483870968
2022-08-28,16,0,12,28,2238,899,737,5.358991470482317,0.4415964285714286
2022-08-29,25,7,9,41,4924,1924,1673,5.555627433149695,0.41439268292682924
2022-08-30,17,4,16,37,3210,1236,1203,5.685308342544076,0.23218378378378376
2022-08-31,25,5,21,51,4653,1794,1442,5.5906529103704665,0.3353607843137255
2022-09-01,17,7,13,37,4889,1937,1087,5.692181726600783,0.22227027027027027
2022-09-02,24,6,7,37,4162,1617,919,5.593251686281475,0.3811135135135135
2022-09-03,19,5,13,37,4287,1666,1224,5.607457417047933,0.3266216216216216
2022-09-04,14,2,10,26,2307,846,519,5.518584273780023,0.43814615384615385
2022-09-05,13,5,13,31,2669,1032,400,5.614356960040912,0.29549677419354836
2022-09-06,20,5,9,34,4107,1575,1520,5.3783343853018835,0.38517058823529415
2022-09-07,15,2,16,33,3234,1188,1128,5.444685893255895,0.3520121212121212
2022-09-08,15,3,12,30,3548,1392,1407,5.47483385764877,0.39725
2022-09-09,15,6,16,37,2642,989,860,5.631496372102239,0.2628189189189189
2022-09-10,16,0,7,23,2402,952,1006,5.579688941790407,0.5863869565217391
2022-09-11,20,5,9,34,5154,2021,1190,5.5795418675415105,0.38925882352941177
2022-09-12,22,10,14,46,4009,1569,1106,5.544171230865958,0.23141956521739132
2022-09-13,15,2,12,29,4497,1672,460,5.914488753611883,0.3290586206896552
2022-09-14,18,6,14,38,3600,1387,967,5.560485768680309,0.27174473684210526
2022-09-15,16,3,10,29,3063,1148,625,5.592950004326995,0.43010000000000004
2022-09-16,25,5,5,35,4350,1693,1205,5.656513416711097,0.4643542857142858
2022-09-17,14,4,6,24,2133,813,761,5.500095297119511,0.31051666666666666
2022-09-18,17,2,5,24,2512,940,491,5.671476137486987,0.49451249999999997
2022-09-19,14,7,12,33,3836,1487,1158,5.59590577093527,0.19934242424242424
2022-09-20,21,7,9,37,5882,2211,1207,5.571747227894028,0.2849189189189189
2022-09-21,19,3,14,36,3843,1482,947,5.513086877849073,0.3602777777777778
2022-09-22,19,8,11,38,4125,1539,801,5.780208655596711,0.2612447368421053
2022-09-23,9,4,15,28,4542,1801,834,5.628371869170094,0.19204642857142856
2022-09-24,14,6,12,32,2534,974,599,5.2725320938243705,0.2343125
2022-09-25,7,3,9,19,2199,877,1177,5.474782367612666,0.20143684210526316
2022-09-26,16,8,13,37,3861,1431,1334,5.686812884858616,0.2297594594594595
2022-09-27,26,6,20,52,4052,1663,2275,5.537398335250261,0.362375
2022-09-28,17,4,13,34,3492,1278,845,5.783094422486693,0.32992058823529413
2022-09-29,14,7,10,31,2565,969,526,5.604328404151046,0.22116129032258064
2022-09-30,24,5,18,47,6410,2517,1231,5.662835070487202,0.26332340425531914
2022-10-01,26,3,11,40,4480,1750,999,5.519146205790043,0.47675999999999996
2022-10-02,18,8,9,35,7685,3090,1406,5.583114462306619,0.2435057142857143
2022-10-03,19,5,5,29,2028,731,809,5.688930122891719,0.35042758620689657
2022-10-04,23,4,11,38,5018,1971,878,5.717261150106856,0.43273684210526314
2022-10-05,16,5,13,34,3384,1273,719,5.702338278929058,0.24700882352941173
2022-10-06,19,4,15,38,3458,1254,660,5.572379732906684,0.3561078947368421
2022-10-07,22,4,12,38,6249,2456,829,5.48773838676706,0.38980263157894735
2022-10-08,8,1,9,18,5593,1361,700,5.599389301669918,0.3855722222222222
2022-10-09,15,5,8,28,3723,1168,1110,5.859145630070032,0.3614107142857143
2022-10-10,14,3,17,34,3228,1202,1204,5.54165579117916,0.3931147058823529
2022-10-11,21,11,12,44,4428,1716,1383,5.531095666221043,0.21993181818181817
2022-10-12,25,7,14,46,6649,2601,738,5.727881195611716,0.4109804347826087
2022-10-13,29,8,13,50,5616,2141,942,5.662554745551965,0.357366
2022-10-14,17,5,6,28,3935,1500,827,5.717125643061188,0.3417642857142857
2022-10-15,14,4,12,30,2206,818,950,5.737112920025203,0.30540666666666666
2022-10-16,18,2,11,31,4048,1646,931,5.536503093823147,0.4626774193548387
2022-10-17,22,7,22,51,8859,3190,1381,5.6382123564910644,0.2932392156862745
2022-10-18,20,3,15,38,3434,1340,1054,5.571704135731645,0.4171184210526316
2022-10-19,20,4,12,36,3454,1303,1444,5.617876538055673,0.37367500000000003
2022-10-20,17,4,12,33,4935,1912,830,5.505677035092241,0.35666363636363635
2022-10-21,18,8,13,39,4074,1622,1049,5.5200316851343585,0.25958974358974357
2022-10-22,14,2,13,29,3165,1228,727,5.317032820329312,0.40318275862068964
2022-10-23,22,6,12,40,3761,1462,903,5.505171848836597,0.29333
2022-10-24,21,2,20,43,3754,1459,1124,5.639993736535536,0.3872651162790698
2022-10-25,21,5,13,39,3848,1564,744,5.529863893140164,0.4020692307692308
2022-10-26,17,6,12,35,3610,1393,1358,5.677106587990345,0.32426285714285713
2022-10-27,20,5,13,38,2672,948,674,5.909060803475396,0.3551473684210526
2022-10-28,13,2,8,23,2720,1111,934,5.821498325711774,0.4482173913043478
2022-10-29,14,5,12,31,3132,1203,1159,5.705656397832416,0.2641516129032258
2022-10-30,11,6,4,21,2195,870,376,5.585091788150728,0.2553714285714286
2022-10-31,16,4,16,36,3799,1533,1224,5.6405285463494685,0.2854527777777778
2022-11-01,19,3,16,38,3060,1117,1172,5.601609649287593,0.41559999999999997
2022-11-02,12,4,9,25,2922,1199,692,6.021161580760623,0.292444
2022-11-03,21,3,17,41,4157,1633,1085,5.505941537724135,0.40318536585365855
2022-11-04,16,5,13,34,6046,2494,639,5.500708793528513,0.28187058823529415
2022-11-05,15,2,10,27,2743,1078,983,5.535739709311078,0.4790259259259259
2022-11-06,9,4,2,15,1658,618,290,5.459661719272238,0.21236
2022-11-07,16,5,12,33,2844,1120,1005,5.674075374284044,0.35597575757575756
2022-11-08,23,12,12,47,4721,1838,1339,5.587523107882814,0.23613829787234042
2022-11-09,43,11,34,88,8530,3345,2509,5.446441054269894,0.34429431818181816
2022-11-10,24,15,28,67,5358,2143,1030,5.485145697565052,0.0791313432835821
2022-11-11,27,11,26,64,5920,2364,2446,5.572804021245269,0.2310703125
2022-11-12,21,7,26,54,4150,1687,1224,5.53941039555371,0.2678907407407407
2022-11-13,36,16,34,86,6757,2706,3139,5.3275373453532415,0.2346174418604651
2022-11-14,42,16,27,85,12132,4813,1454,5.5335020704335784,0.35126235294117647
2022-11-15,33,9,24,66,5495,2054,1072,5.550285050508313,0.3168909090909091
2022-11-16,37,17,22,76,8720,3499,1805,5.5955500961771305,0.23318947368421053
2022-11-17,32,9,21,62,7132,2752,964,5.7899797334602265,0.3703645161290322
2022-11-18,27,14,23,64,6166,2455,1250,5.511594564486154,0.231546875
2022-11-19,24,17,14,55,6157,2382,1198,5.759948634484663,0.16749090909090908
2022-11-20,23,8,24,55,5364,2127,1392,5.510833800952507,0.30830727272727276
2022-11-21,32,11,24,67,7509,3027,1887,5.5720538158723985,0.30559701492537317
2022-11-22,34,16,29,79,8792,3624,1440,5.636862813671007,0.22946455696202533
2022-11-23,32,8,28,68,9247,3504,1922,5.6861827528864834,0.32980588235294117
2022-11-24,26,7,15,48,6180,2522,2990,5.645582731052617,0.32621875
2022-11-25,27,7,17,51,5885,2394,1690,5.614567602185681,0.3605176470588235
2022-11-26,24,7,16,47,4314,1694,2044,5.601463499751503,0.33729574468085105
2022-11-27,29,3,19,51,4051,1555,2157,5.725223389171374,0.3806941176470588
2022-11-28,24,7,34,65,5195,1972,2979,5.59234862291214,0.21718923076923077
2022-11-29,45,11,38,94,11382,4519,2832,5.650870205010908,0.31950106382978727
2022-11-30,26,7,10,43,3396,1222,919,5.6793921988014,0.39941162790697676
2022-12-01,20,7,11,38,3614,1359,1186,5.814865782827112,0.32193947368421055
2022-12-02,26,11,19,56,6294,2488,1591,5.7090172469555,0.2438642857142857
2022-12-03,20,4,12,36,3846,1563,1226,5.65554354909467,0.36593888888888887
2022-12-04,22,5,10,37,4245,1646,2221,5.632189415219206,0.4080945945945946
2022-12-05,21,13,11,45,4795,1851,973,5.524373211703882,0.19879555555555556
2022-12-06,29,12,16,57,5656,2149,1330,5.561614009449648,0.29416842105263163
2022-12-07,30,5,27,62,6506,2534,2452,5.6456380445636745,0.33276290322580643
2022-12-08,29,9,16,54,7429,2960,1427,5.639504716564636,0.3357722222222222
2022-12-09,26,3,16,45,5730,2309,3759,5.663678645621824,0.4869866666666667
2022-12-10,20,8,24,52,5134,2009,1938,5.6276418313976535,0.23504807692307692
2022-12-11,57,9,36,102,10817,4361,2874,5.592600099090942,0.40017745098039215
2022-12-12,49,16,20,85,9156,3600,2123,5.6033066873369854,0.39912235294117643
2022-12-13,40,10,27,77,7098,2516,1207,5.523875507217034,0.3956064935064935
2022-12-14,37,10,27,74,8125,3185,1904,5.546443642830548,0.32635135135135135
2022-12-15,27,5,14,46,4993,1976,956,5.5775899040986054,0.4129304347826087
2022-12-16,40,8,11,59,5649,2059,1712,5.543476008982679,0.4279406779661017
2022-12-17,28,7,19,54,6454,2543,1431,5.474462335166058,0.37501481481481486
2022-12-18,28,8,15,51,5895,2325,1525,5.580945129694994,0.3920921568627451
2022-12-19,20,10,16,46,5091,1982,1448,5.599336720074199,0.2110891304347826
2022-12-20,21,11,14,46,6409,2467,1762,5.540058474922784,0.2284826086956522
2022-12-21,27,3,21,51,5928,2317,1551,5.535941964607355,0.38957254901960786
2022-12-22,17,4,15,36,3022,1109,973,5.686002836404927,0.3081
2022-12-23,21,4,21,46,3763,1458,1400,5.689064924119644,0.33147173913043476
2022-12-24,17,2,23,42,3316,1268,1129,5.812289066640089,0.37967142857142855
2022-12-25,26,3,16,45,3210,1232,1543,5.8057872581386345,0.4720444444444445
2022-12-26,24,7,19,50,4490,1710,801,5.602248919056284,0.33292
2022-12-27,14,1,17,32,2662,1111,745,5.515311375918535,0.3154125
2022-12-28,35,3,25,63,7155,2850,1636,5.401527257861438,0.44373174603174603
2022-12-29,28,1,21,50,5753,1627,1212,5.3786744992378805,0.453084
2022-12-30,33,7,23,63,7052,2743,1900,5.628004025839922,0.37603968253968256
2022-12-31,20,8,11,39,3064,1115,601,5.491906297071253,0.28881282051282053
