posted_on,positive_count,negative_count,neutral_count,total_posts,total_words,total_comments
2019-01-01,16,3,18,37,2068,750
2019-01-02,21,4,56,81,3005,1502
2019-01-03,26,7,54,87,3850,1192
2019-01-04,19,3,41,63,1805,1293
2019-01-05,30,2,39,71,2634,1053
2019-01-06,23,3,23,49,1862,905
2019-01-07,32,5,48,85,7376,1087
2019-01-08,34,5,42,81,8297,1204
2019-01-09,25,6,35,66,4068,923
2019-01-10,22,6,53,81,1793,1486
2019-01-11,21,1,47,69,4865,1106
2019-01-12,18,1,23,42,1884,674
2019-01-13,23,3,33,59,7362,1003
2019-01-14,34,4,62,100,7706,1176
2019-01-15,23,3,49,75,6023,1986
2019-01-16,26,5,38,69,7057,835
2019-01-17,28,5,41,74,4200,910
2019-01-18,24,7,32,63,3479,1094
2019-01-19,25,2,23,50,3169,593
2019-01-20,10,4,19,33,1853,711
2019-01-21,24,1,40,65,5234,934
2019-01-22,23,4,40,67,4496,1881
2019-01-23,35,3,51,89,4813,1638
2019-01-24,50,29,188,267,5813,1392
2019-01-25,30,5,32,67,4852,884
2019-01-26,8,3,23,34,1024,394
2019-01-27,12,3,20,35,2205,819
2019-01-28,76,0,88,164,4399,1216
2019-01-29,20,2,138,160,3187,705
2019-01-30,28,2,38,68,5965,1041
2019-01-31,28,1,49,78,7306,875
2019-02-01,22,3,30,55,3757,694
2019-02-02,14,2,33,49,3224,545
2019-02-03,12,3,21,36,1693,396
2019-02-04,20,4,31,55,8136,689
2019-02-05,21,2,37,60,3495,722
2019-02-06,26,4,42,72,5502,1038
2019-02-07,42,4,39,85,7206,1017
2019-02-08,12,1,27,40,1925,1100
2019-02-09,13,2,18,33,1954,724
2019-02-10,13,3,23,39,2215,783
2019-02-11,27,2,33,62,3311,806
2019-02-12,15,1,34,50,2762,757
2019-02-13,24,3,38,65,5458,1048
2019-02-14,17,0,31,48,3291,622
2019-02-15,18,3,27,48,4674,887
2019-02-16,12,2,27,41,2578,707
2019-02-17,19,3,22,44,2531,1369
2019-02-18,31,4,48,83,4802,2414
2019-02-19,28,5,62,95,8678,1454
2019-02-20,30,3,51,84,7283,1435
2019-02-21,17,2,39,58,4220,987
2019-02-22,21,3,44,68,2837,976
2019-02-23,13,5,23,41,2423,1625
2019-02-24,17,0,22,39,2047,1617
2019-02-25,16,3,31,50,8373,1436
2019-02-26,14,4,30,48,4364,783
2019-02-27,19,0,37,56,2324,1078
2019-02-28,35,4,34,73,4285,1372
2019-03-01,22,1,40,63,4187,1027
2019-03-02,11,4,15,30,761,572
2019-03-03,9,2,15,26,1858,614
2019-03-04,25,1,33,59,3433,932
2019-03-05,27,3,44,74,6649,918
2019-03-06,26,3,42,71,3922,1009
2019-03-07,19,2,37,58,3258,828
2019-03-08,25,3,31,59,4453,1252
2019-03-09,10,3,20,33,2835,810
2019-03-10,17,2,16,35,6685,485
2019-03-11,15,1,32,48,4307,991
2019-03-12,24,5,37,66,4739,703
2019-03-13,25,3,36,64,3997,822
2019-03-14,28,2,36,66,9177,765
2019-03-15,14,0,30,44,3100,753
2019-03-16,14,3,20,37,2482,576
2019-03-17,15,0,15,30,4917,717
2019-03-18,20,1,29,50,4082,664
2019-03-19,26,2,33,61,4770,1189
2019-03-20,32,2,41,75,4865,707
2019-03-21,15,2,27,44,4988,911
2019-03-22,16,4,32,52,4440,890
2019-03-23,16,2,17,35,933,510
2019-03-24,14,0,19,33,1580,573
2019-03-25,15,1,25,41,1493,676
2019-03-26,20,1,27,48,4541,870
2019-03-27,21,3,34,58,5631,851
2019-03-28,29,4,31,64,3730,823
2019-03-29,19,3,27,49,4081,1081
2019-03-30,7,1,24,32,1703,666
2019-03-31,11,3,20,34,3950,586
2019-04-01,23,5,36,64,3099,1275
2019-04-02,21,4,24,49,4494,2584
2019-04-03,31,3,33,67,4089,2743
2019-04-04,24,4,31,59,4878,1289
2019-04-05,22,4,28,54,2274,1298
2019-04-06,7,1,17,25,832,788
2019-04-07,14,4,13,31,1005,1267
2019-04-08,21,3,22,46,2331,1464
2019-04-09,33,4,34,71,5863,1165
2019-04-10,16,1,34,51,2513,1589
2019-04-11,13,5,29,47,2481,1433
2019-04-12,19,5,17,41,1553,1221
2019-04-13,10,3,20,33,2593,825
2019-04-14,21,0,16,37,2227,813
2019-04-15,18,3,17,38,7660,1045
2019-04-16,19,0,46,65,3262,1080
2019-04-17,23,0,28,51,2946,1794
2019-04-18,20,1,34,55,3773,1229
2019-04-19,11,4,28,43,1510,888
2019-04-20,14,4,15,33,2037,859
2019-04-21,11,5,16,32,1717,653
2019-04-22,16,1,20,37,1775,829
2019-04-23,12,2,26,40,2655,1164
2019-04-24,14,6,33,53,2655,1702
2019-04-25,22,4,36,62,2924,1568
2019-04-26,15,2,24,41,4185,1076
2019-04-27,12,1,25,38,2788,836
2019-04-28,11,3,24,38,2883,664
2019-04-29,20,0,19,39,3450,770
2019-04-30,18,6,40,64,4129,897
2019-05-01,14,3,30,47,4267,848
2019-05-02,25,4,34,63,3309,983
2019-05-03,24,1,47,72,3727,1329
2019-05-04,18,2,18,38,2319,820
2019-05-05,10,3,19,32,915,538
2019-05-06,34,3,26,63,3011,1440
2019-05-07,12,3,27,42,3174,1287
2019-05-08,20,5,34,59,3576,1292
2019-05-09,21,3,27,51,2687,1316
2019-05-10,20,3,29,52,2078,1219
2019-05-11,17,1,24,42,2167,2517
2019-05-12,16,1,24,41,1463,964
2019-05-13,23,7,39,69,2505,2050
2019-05-14,27,3,44,74,4674,2281
2019-05-15,28,6,36,70,5417,4574
2019-05-16,35,2,45,82,5351,2535
2019-05-17,21,6,34,61,3281,1353
2019-05-18,13,0,25,38,2023,968
2019-05-19,27,5,26,58,4586,1192
2019-05-20,15,4,23,42,4375,887
2019-05-21,22,6,46,74,2838,1654
2019-05-22,20,3,44,67,2433,1203
2019-05-23,19,6,43,68,3239,977
2019-05-24,15,6,31,52,1689,965
2019-05-25,13,5,25,43,1783,812
2019-05-26,13,1,20,34,2716,1333
2019-05-27,16,2,24,42,4629,1247
2019-05-28,25,4,27,56,2270,1419
2019-05-29,15,4,34,53,3602,1473
2019-05-30,21,4,35,60,1999,1761
2019-05-31,15,3,30,48,1735,1202
2019-06-01,16,5,19,40,1858,784
2019-06-02,15,3,24,42,1754,779
2019-06-03,17,2,37,56,2363,1130
2019-06-04,19,3,36,58,2729,913
2019-06-05,13,2,30,45,2032,891
2019-06-06,14,3,25,42,1079,892
2019-06-07,8,2,43,53,2603,875
2019-06-08,14,0,28,42,3843,581
2019-06-09,10,0,17,27,1064,728
2019-06-10,19,3,35,57,3510,1344
2019-06-11,15,2,27,44,2708,911
2019-06-12,15,7,34,56,4143,1509
2019-06-13,22,5,37,64,3359,1064
2019-06-14,14,3,30,47,1943,1186
2019-06-15,10,2,20,32,1876,959
2019-06-16,11,0,18,29,477,877
2019-06-17,17,2,26,45,1843,1312
2019-06-18,35,4,42,81,5174,1955
2019-06-19,31,4,34,69,6999,1135
2019-06-20,24,2,28,54,3606,1446
2019-06-21,30,1,35,66,2843,2913
2019-06-22,28,10,23,61,3161,2096
2019-06-23,10,1,31,42,1727,1355
2019-06-24,14,5,46,65,3332,1401
2019-06-25,16,2,41,59,2742,2252
2019-06-26,31,7,45,83,3186,3657
2019-06-27,24,5,39,68,2456,1994
2019-06-28,17,3,24,44,4449,1522
2019-06-29,7,2,15,24,1065,1079
2019-06-30,13,1,18,32,1583,895
2019-07-01,13,2,32,47,2252,1093
2019-07-02,8,3,28,39,2138,1233
2019-07-03,16,3,28,47,2489,1217
2019-07-04,19,1,38,58,2561,800
2019-07-05,9,4,22,35,3367,822
2019-07-06,9,2,16,27,1220,654
2019-07-07,6,4,15,25,1502,766
2019-07-08,12,3,34,49,3302,953
2019-07-09,23,3,24,50,3512,1575
2019-07-10,17,3,32,52,3104,1742
2019-07-11,20,2,28,50,3747,1273
2019-07-12,10,5,26,41,2497,850
2019-07-13,13,3,20,36,746,749
2019-07-14,13,3,24,40,1674,1817
2019-07-15,19,2,43,64,2586,1692
2019-07-16,12,1,35,48,1884,2357
2019-07-17,17,2,35,54,4833,1485
2019-07-18,27,7,33,67,1762,1048
2019-07-19,15,0,22,37,5001,882
2019-07-20,19,5,21,45,1527,1019
2019-07-21,4,1,18,23,834,485
2019-07-22,19,3,28,50,3959,921
2019-07-23,17,5,31,53,4820,1051
2019-07-24,15,2,40,57,3019,977
2019-07-25,18,1,38,57,4288,798
2019-07-26,12,2,27,41,2817,759
2019-07-27,20,2,29,51,1758,628
2019-07-28,10,2,20,32,930,604
2019-07-29,17,3,21,41,4511,947
2019-07-30,14,1,20,35,3572,674
2019-07-31,23,3,31,57,1922,915
2019-08-01,7,2,18,27,678,840
2019-08-02,20,5,22,47,1358,900
2019-08-03,25,1,18,44,2564,543
2019-08-04,17,2,13,32,697,676
2019-08-05,20,4,26,50,1757,1215
2019-08-06,16,2,27,45,3022,1155
2019-08-07,29,1,29,59,2567,1569
2019-08-08,15,2,33,50,4532,1124
2019-08-09,22,2,26,50,1977,1460
2019-08-10,7,2,27,36,1097,618
2019-08-11,7,4,17,28,3782,810
2019-08-12,13,1,35,49,2065,642
2019-08-13,21,2,36,59,2394,835
2019-08-14,19,3,38,60,3734,1720
2019-08-15,23,2,38,63,985,1170
2019-08-16,22,1,25,48,1999,860
2019-08-17,11,3,23,37,1531,789
2019-08-18,20,2,17,39,1709,2958
2019-08-19,38,4,36,78,9948,1055
2019-08-20,33,3,33,69,7233,1414
2019-08-21,23,2,21,46,3694,1998
2019-08-22,16,6,33,55,2198,1144
2019-08-23,27,4,26,57,4155,1236
2019-08-24,19,2,19,40,4043,1171
2019-08-25,11,2,17,30,1746,739
2019-08-26,18,3,26,47,4962,871
2019-08-27,23,3,24,50,2961,832
2019-08-28,13,0,22,35,3226,1344
2019-08-29,17,0,31,48,3168,1089
2019-08-30,19,0,17,36,2265,662
2019-08-31,9,1,17,27,2441,536
2019-09-01,11,0,21,32,2152,603
2019-09-02,15,2,13,30,1394,605
2019-09-03,19,4,30,53,4932,925
2019-09-04,23,1,28,52,2061,907
2019-09-05,21,1,30,52,4559,1359
2019-09-06,15,3,22,40,3847,761
2019-09-07,10,0,16,26,985,596
2019-09-08,16,2,12,30,1492,389
2019-09-09,17,3,23,43,3168,675
2019-09-10,15,2,22,39,2954,682
2019-09-11,16,3,22,41,1800,711
2019-09-12,28,4,28,60,3322,744
2019-09-13,12,0,18,30,2138,658
2019-09-14,16,1,19,36,1312,699
2019-09-15,15,3,19,37,2481,825
2019-09-16,15,2,30,47,3558,1081
2019-09-17,17,5,19,41,3017,1671
2019-09-18,18,1,34,53,4786,970
2019-09-19,19,2,32,53,1540,1278
2019-09-20,26,2,26,54,5186,1155
2019-09-21,16,2,14,32,2169,539
2019-09-22,10,2,15,27,3073,614
2019-09-23,18,2,28,48,3145,975
2019-09-24,17,3,26,46,3782,1776
2019-09-25,19,3,25,47,3830,989
2019-09-26,13,3,15,31,2910,1192
2019-09-27,20,2,28,50,2427,801
2019-09-28,9,0,10,19,1605,366
2019-09-29,18,1,24,43,2943,463
2019-09-30,12,3,23,38,1621,607
2019-10-01,16,5,22,43,3683,574
2019-10-02,20,2,32,54,4154,561
2019-10-03,7,4,13,24,642,536
2019-10-04,17,2,25,44,2196,710
2019-10-05,13,5,15,33,1757,369
2019-10-06,5,3,12,20,571,414
2019-10-07,13,3,19,35,2648,660
2019-10-08,23,2,23,48,1818,544
2019-10-09,18,2,25,45,3869,1111
2019-10-10,21,4,35,60,2141,781
2019-10-11,16,3,18,37,2946,607
2019-10-12,21,3,25,49,1918,533
2019-10-13,6,2,11,19,1083,398
2019-10-14,7,4,23,34,1375,522
2019-10-15,14,2,31,47,2679,685
2019-10-16,14,2,22,38,1023,635
2019-10-17,10,2,20,32,2348,646
2019-10-18,14,1,20,35,1755,405
2019-10-19,7,2,18,27,929,486
2019-10-20,8,3,21,32,2003,321
2019-10-21,5,2,28,35,1684,703
2019-10-22,15,6,18,39,3021,676
2019-10-23,20,5,20,45,3159,1020
2019-10-24,13,4,20,37,1795,527
2019-10-25,5,3,24,32,2031,1102
2019-10-26,9,2,10,21,1073,539
2019-10-27,9,1,6,16,675,441
2019-10-28,15,1,28,44,2967,546
2019-10-29,10,0,23,33,1063,475
2019-10-30,13,4,19,36,1639,466
2019-10-31,21,1,22,44,4310,654
2019-11-01,11,0,17,28,1371,401
2019-11-02,9,3,6,18,544,218
2019-11-03,9,1,9,19,1631,472
2019-11-04,15,0,30,45,2475,700
2019-11-05,12,2,31,45,2807,485
2019-11-06,21,0,23,44,2857,762
2019-11-07,16,0,26,42,1366,615
2019-11-08,13,1,20,34,1456,518
2019-11-09,7,2,13,22,831,322
2019-11-10,11,0,11,22,3578,311
2019-11-11,11,3,22,36,2071,454
2019-11-12,8,1,25,34,1426,337
2019-11-13,19,0,13,32,2332,577
2019-11-14,16,1,16,33,2671,501
2019-11-15,11,0,20,31,2544,553
2019-11-16,4,1,13,18,707,225
2019-11-17,13,1,20,34,2747,378
2019-11-18,9,0,23,32,1027,454
2019-11-19,14,2,18,34,1888,447
2019-11-20,15,0,23,38,1881,818
2019-11-21,19,6,34,59,2389,1025
2019-11-22,10,2,21,33,1040,1099
2019-11-23,10,2,18,30,1735,364
2019-11-24,10,3,14,27,1126,591
2019-11-25,19,2,26,47,2799,698
2019-11-26,25,1,31,57,4012,516
2019-11-27,12,2,40,54,3286,632
2019-11-28,17,1,13,31,1134,335
2019-11-29,11,0,23,34,1514,445
2019-11-30,16,2,19,37,1554,317
2019-12-01,13,2,20,35,1649,389
2019-12-02,9,3,14,26,1400,435
2019-12-03,21,2,30,53,2770,614
2019-12-04,12,3,28,43,2809,2122
2019-12-05,23,2,28,53,3626,558
2019-12-06,13,1,20,34,1978,649
2019-12-07,10,4,20,34,1178,517
2019-12-08,17,0,17,34,1607,501
2019-12-09,12,3,29,44,1410,558
2019-12-10,35,2,33,70,4215,486
2019-12-11,18,3,26,47,1443,677
2019-12-12,23,1,16,40,2635,516
2019-12-13,16,5,25,46,1707,368
2019-12-14,10,2,18,30,1950,692
2019-12-15,13,6,16,35,3482,562
2019-12-16,20,1,24,45,1703,1097
2019-12-17,20,1,15,36,2297,1061
2019-12-18,22,2,23,47,2505,1053
2019-12-19,21,4,42,67,4355,604
2019-12-20,22,2,17,41,1588,431
2019-12-21,11,1,25,37,892,483
2019-12-22,6,2,11,19,1042,5815
2019-12-23,20,2,10,32,4396,635
2019-12-24,5,2,15,22,458,348
2019-12-25,15,0,12,27,922,365
2019-12-26,12,2,28,42,1816,561
2019-12-27,14,1,14,29,1868,438
2019-12-28,15,0,20,35,1056,283
2019-12-29,7,0,7,14,294,430
2019-12-30,21,1,54,76,3658,444
2019-12-31,6,3,53,62,1142,463
2020-01-01,12,5,38,55,1197,403
2020-01-02,15,5,37,57,2140,385
2020-01-03,18,4,43,65,2083,464
2020-01-04,8,3,39,50,2070,430
2020-01-05,12,3,41,56,1295,383
2020-01-06,3,1,19,23,829,511
2020-01-07,12,1,33,46,1472,646
2020-01-08,19,3,27,49,2615,585
2020-01-09,12,1,27,40,1599,560
2020-01-10,16,4,10,30,1038,512
2020-01-11,10,1,11,22,1055,394
2020-01-12,9,3,25,37,1329,406
2020-01-13,23,0,36,59,2029,579
2020-01-14,26,4,31,61,3213,1306
2020-01-15,20,2,32,54,3842,739
2020-01-16,23,5,21,49,1286,580
2020-01-17,15,1,23,39,3135,933
2020-01-18,13,2,24,39,1997,755
2020-01-19,12,2,16,30,1637,501
2020-01-20,13,3,40,56,1451,504
2020-01-21,13,2,32,47,2918,428
2020-01-22,26,4,33,63,4159,760
2020-01-23,10,2,19,31,675,581
2020-01-24,13,6,23,42,1721,648
2020-01-25,9,1,17,27,1395,473
2020-01-26,7,1,9,17,316,460
2020-01-27,8,7,29,44,2294,723
2020-01-28,11,3,35,49,2300,634
2020-01-29,11,1,30,42,1302,644
2020-01-30,20,7,19,46,1140,1197
2020-01-31,14,1,50,65,2603,672
2020-02-01,14,4,52,70,2132,604
2020-02-02,30,5,70,105,2218,937
2020-02-03,28,3,81,112,2260,970
2020-02-04,15,6,41,62,1350,617
2020-02-05,10,2,26,38,1768,2404
2020-02-06,22,4,31,57,4318,1629
2020-02-07,29,7,63,99,4521,1286
2020-02-08,30,5,47,82,1689,1109
2020-02-09,18,4,64,86,2570,1161
2020-02-10,30,3,32,65,2019,832
2020-02-11,16,0,37,53,1626,1788
2020-02-12,23,7,45,75,2675,3412
2020-02-13,24,6,39,69,2404,1634
2020-02-14,21,2,22,45,2031,1833
2020-02-15,12,9,33,54,1940,1409
2020-02-16,30,3,30,63,3965,1200
2020-02-17,21,1,42,64,1224,1091
2020-02-18,24,8,32,64,1901,1476
2020-02-19,19,1,27,47,1650,1159
2020-02-20,24,4,28,56,2652,1093
2020-02-21,29,3,26,58,1543,916
2020-02-22,11,1,16,28,1826,1252
2020-02-23,8,1,20,29,1518,1086
2020-02-24,15,5,33,53,1241,656
2020-02-25,19,5,32,56,1660,782
2020-02-26,22,5,23,50,2309,1227
2020-02-27,19,1,24,44,1100,741
2020-02-28,15,1,43,59,4229,688
2020-02-29,16,2,13,31,1846,511
2020-03-01,15,3,14,32,1064,445
2020-03-02,16,6,29,51,1835,657
2020-03-03,21,4,44,69,3369,645
2020-03-04,22,4,29,55,3138,686
2020-03-05,16,5,35,56,3123,791
2020-03-06,17,3,25,45,1307,913
2020-03-07,9,7,23,39,1473,680
2020-03-08,13,1,22,36,1853,1018
2020-03-09,22,3,20,45,3513,1089
2020-03-10,14,1,18,33,2355,718
2020-03-11,13,1,26,40,2743,862
2020-03-12,18,4,32,54,3067,4150
2020-03-13,29,3,25,57,3166,1628
2020-03-14,12,4,21,37,1173,1123
2020-03-15,7,3,11,21,658,833
2020-03-16,8,2,14,24,1369,1212
2020-03-17,12,3,24,39,1383,672
2020-03-18,9,4,23,36,1394,771
2020-03-19,15,0,22,37,1529,816
2020-03-20,8,3,17,28,1003,802
2020-03-21,9,2,16,27,852,413
2020-03-22,4,2,11,17,1894,417
2020-03-23,13,2,20,35,1281,511
2020-03-24,15,3,19,37,4052,489
2020-03-25,17,0,17,34,2144,370
2020-03-26,11,1,15,27,1020,384
2020-03-27,9,3,12,24,2259,380
2020-03-28,8,3,20,31,1372,370
2020-03-29,4,1,10,15,554,221
2020-03-30,14,0,23,37,1015,235
2020-03-31,12,4,29,45,1834,299
2020-04-01,19,2,24,45,2974,347
2020-04-02,16,1,26,43,1174,360
2020-04-03,13,3,28,44,2969,299
2020-04-04,7,2,19,28,626,254
2020-04-05,8,1,14,23,1093,234
2020-04-06,26,2,28,56,2967,708
2020-04-07,10,1,29,40,1811,433
2020-04-08,20,1,26,47,3185,482
2020-04-09,8,6,29,43,1602,408
2020-04-10,17,4,17,38,1669,369
2020-04-11,8,2,15,25,727,310
2020-04-12,6,0,19,25,1653,235
2020-04-13,12,5,34,51,3775,400
2020-04-14,17,1,31,49,2322,292
2020-04-15,9,4,21,34,1915,400
2020-04-16,14,2,34,50,1529,577
2020-04-17,15,2,22,39,1786,399
2020-04-18,16,2,26,44,2862,730
2020-04-19,15,2,32,49,2251,366
2020-04-20,21,2,33,56,4202,525
2020-04-21,16,1,26,43,2145,565
2020-04-22,10,5,32,47,1714,519
2020-04-23,10,5,25,40,1148,773
2020-04-24,13,1,27,41,1284,466
2020-04-25,15,3,18,36,1400,617
2020-04-26,9,5,14,28,799,620
2020-04-27,11,4,21,36,2397,537
2020-04-28,22,3,30,55,1921,363
2020-04-29,12,4,27,43,2068,3
2020-04-30,18,1,25,44,1381,2
2020-05-01,15,1,25,41,1337,734
2020-05-02,9,3,12,24,1540,385
2020-05-03,4,5,17,26,1752,288
2020-05-04,10,1,28,39,994,387
2020-05-05,13,3,25,41,1388,479
2020-05-06,14,2,22,38,1492,593
2020-05-07,12,3,40,55,3528,799
2020-05-08,17,4,33,54,3500,576
2020-05-09,4,4,13,21,602,521
2020-05-10,13,5,25,43,1411,502
2020-05-11,8,4,39,51,1678,668
2020-05-12,14,3,41,58,1750,542
2020-05-13,13,2,24,39,3555,716
2020-05-14,17,4,30,51,2689,1002
2020-05-15,23,4,30,57,3349,726
2020-05-16,16,3,22,41,2902,632
2020-05-17,13,3,31,47,1202,771
2020-05-18,17,1,36,54,2459,532
2020-05-19,24,0,26,50,1751,840
2020-05-20,20,6,43,69,2872,576
2020-05-21,13,4,35,52,1726,639
2020-05-22,17,1,36,54,3235,641
2020-05-23,10,5,23,38,3023,563
2020-05-24,14,3,23,40,1036,455
2020-05-25,24,3,38,65,2366,535
2020-05-26,28,5,38,71,3404,615
2020-05-27,15,4,46,65,1815,540
2020-05-28,16,8,28,52,1581,707
2020-05-29,15,5,19,39,1620,606
2020-05-30,11,1,23,35,1270,876
2020-05-31,15,4,26,45,800,470
2020-06-01,15,3,37,55,4017,704
2020-06-02,13,2,23,38,1124,871
2020-06-03,21,3,34,58,3465,792
2020-06-04,21,2,26,49,2808,509
2020-06-05,17,2,41,60,2470,409
2020-06-06,9,1,28,38,1072,340
2020-06-07,20,2,25,47,3305,451
2020-06-08,16,3,30,49,3742,490
2020-06-09,18,1,27,46,1862,496
2020-06-10,14,2,26,42,1981,794
2020-06-11,14,2,26,42,1295,667
2020-06-12,11,3,21,35,1024,379
2020-06-13,10,3,23,36,2580,355
2020-06-14,15,2,33,50,3667,507
2020-06-15,11,2,25,38,1108,523
2020-06-16,20,4,37,61,2259,610
2020-06-17,19,4,27,50,4378,448
2020-06-18,23,4,33,60,4135,1257
2020-06-19,11,3,28,42,5391,721
2020-06-20,13,2,31,46,2267,6612
2020-06-21,8,3,17,28,754,497
2020-06-22,9,5,36,50,1501,815
2020-06-23,13,4,37,54,2418,819
2020-06-24,13,1,29,43,2337,916
2020-06-25,9,2,21,32,1788,624
2020-06-26,11,2,30,43,2512,581
2020-06-27,13,3,22,38,2801,425
2020-06-28,7,3,21,31,1897,467
2020-06-29,7,6,27,40,2672,429
2020-06-30,11,2,24,37,5938,651
2020-07-01,19,3,26,48,1822,571
2020-07-02,14,5,17,36,978,540
2020-07-03,9,4,37,50,2366,455
2020-07-04,25,1,15,41,1904,269
2020-07-05,8,3,19,30,690,274
2020-07-06,19,3,41,63,2699,764
2020-07-07,19,3,31,53,2277,601
2020-07-08,18,1,33,52,1686,750
2020-07-09,15,3,27,45,2199,949
2020-07-10,12,4,23,39,2165,540
2020-07-11,10,2,22,34,1753,411
2020-07-12,7,3,13,23,1007,602
2020-07-13,14,1,26,41,1084,685
2020-07-14,13,2,23,38,1181,566
2020-07-15,8,4,20,32,1708,722
2020-07-16,5,2,22,29,1842,561
2020-07-17,12,6,35,53,1558,552
2020-07-18,10,3,24,37,937,552
2020-07-19,7,4,23,34,1511,530
2020-07-20,17,2,33,52,2968,570
2020-07-21,16,2,25,43,2645,696
2020-07-22,13,5,33,51,1621,1346
2020-07-23,11,5,35,51,1171,1419
2020-07-24,15,6,27,48,1201,1353
2020-07-25,22,4,32,58,1938,2116
2020-07-26,16,5,53,74,2729,2098
2020-07-27,24,6,39,69,1700,1798
2020-07-28,16,3,41,60,2485,951
2020-07-29,22,6,32,60,12880,1647
2020-07-30,14,5,42,61,3106,1153
2020-07-31,27,3,45,75,14101,1785
2020-08-01,25,3,46,74,7927,3058
2020-08-02,19,9,52,80,6528,1213
2020-08-03,24,8,46,78,2707,1632
2020-08-04,20,3,36,59,2706,1099
2020-08-05,17,9,41,67,4167,1595
2020-08-06,19,5,30,54,2558,1020
2020-08-07,14,9,33,56,2342,1163
2020-08-08,19,4,33,56,1816,901
2020-08-09,15,5,30,50,1745,1056
2020-08-10,18,4,54,76,7337,1143
2020-08-11,28,10,51,89,2469,1272
2020-08-12,33,7,72,112,4149,2206
2020-08-13,25,11,66,102,3322,2529
2020-08-14,29,6,56,91,2504,2246
2020-08-15,19,3,35,57,2484,1082
2020-08-16,14,5,60,79,2717,1006
2020-08-17,22,10,59,91,4638,1531
2020-08-18,24,9,40,73,2729,1139
2020-08-19,24,10,40,74,2238,1180
2020-08-20,29,4,49,82,2659,1501
2020-08-21,24,7,51,82,2709,1128
2020-08-22,17,8,21,46,1661,736
2020-08-23,15,7,24,46,1170,523
2020-08-24,18,4,41,63,3460,990
2020-08-25,22,8,44,74,2266,1176
2020-08-26,13,4,59,76,3563,1244
2020-08-27,25,9,42,76,4640,1145
2020-08-28,21,5,50,76,2127,810
2020-08-29,11,4,30,45,2022,1022
2020-08-30,22,7,43,72,4534,1324
2020-08-31,22,8,59,89,4936,1946
2020-09-01,31,8,81,120,8451,2811
2020-09-02,34,9,79,122,6167,1945
2020-09-03,31,8,71,110,3349,1590
2020-09-04,20,8,47,75,4524,991
2020-09-05,22,5,57,84,3937,1611
2020-09-06,20,7,38,65,4994,900
2020-09-07,15,10,35,60,2394,744
2020-09-08,18,8,41,67,2300,781
2020-09-09,10,9,29,48,3586,864
2020-09-10,22,7,39,68,4828,944
2020-09-11,17,6,48,71,4270,748
2020-09-12,15,2,52,69,2787,879
2020-09-13,14,2,26,42,1069,558
2020-09-14,19,5,42,66,3543,972
2020-09-15,32,5,44,81,4367,812
2020-09-16,22,3,56,81,5389,1189
2020-09-17,29,6,57,92,3171,1892
2020-09-18,18,5,51,74,3636,1839
2020-09-19,16,7,45,68,3002,950
2020-09-20,20,4,33,57,2554,764
2020-09-21,19,10,52,81,4483,992
2020-09-22,15,3,41,59,4527,1031
2020-09-23,21,3,48,72,3346,1093
2020-09-24,21,5,35,61,3306,900
2020-09-25,28,7,48,83,8551,955
2020-09-26,14,6,56,76,4074,627
2020-09-27,12,5,37,54,2219,534
2020-09-28,19,7,52,78,4507,899
2020-09-29,15,6,50,71,2469,855
2020-09-30,24,4,51,79,3195,757
2020-10-01,18,5,28,51,1603,777
2020-10-02,19,4,44,67,3937,720
2020-10-03,16,6,62,84,4308,673
2020-10-04,8,5,30,43,2496,579
2020-10-05,21,6,34,61,3467,579
2020-10-06,18,4,43,65,2290,640
2020-10-07,35,5,56,96,3494,784
2020-10-08,27,11,36,74,5718,647
2020-10-09,15,8,30,53,2366,665
2020-10-10,14,5,32,51,2191,453
2020-10-11,11,4,30,45,2042,965
2020-10-12,23,3,45,71,2994,716
2020-10-13,26,5,35,66,3042,589
2020-10-14,25,1,47,73,4798,627
2020-10-15,22,1,38,61,3892,640
2020-10-16,13,7,40,60,2516,774
2020-10-17,8,5,37,50,2161,685
2020-10-18,8,7,25,40,2259,604
2020-10-19,26,3,37,66,2623,638
2020-10-20,17,8,32,57,3097,938
2020-10-21,30,14,33,77,2721,1635
2020-10-22,22,7,43,72,3690,1188
2020-10-23,29,7,44,80,6040,794
2020-10-24,17,9,47,73,3054,619
2020-10-25,25,6,26,57,8635,605
2020-10-26,18,7,50,75,3318,659
2020-10-27,30,6,46,82,6285,751
2020-10-28,21,6,32,59,3338,751
2020-10-29,21,9,35,65,3502,921
2020-10-30,26,6,40,72,3579,774
2020-10-31,11,8,29,48,1296,377
2020-11-01,20,6,27,53,2056,715
2020-11-02,34,8,45,87,3936,833
2020-11-03,25,7,50,82,3472,702
2020-11-04,24,10,35,69,3097,1394
2020-11-05,31,7,50,88,4771,1462
2020-11-06,26,8,58,92,4767,1557
2020-11-07,19,5,34,58,1975,749
2020-11-08,16,10,33,59,1882,602
2020-11-09,26,9,47,82,3292,1090
2020-11-10,27,3,65,95,3924,1175
2020-11-11,25,2,48,75,2878,1083
2020-11-12,20,4,60,84,4645,1038
2020-11-13,28,5,43,76,3638,1049
2020-11-14,22,7,30,59,3138,660
2020-11-15,17,8,47,72,4327,742
2020-11-16,28,5,55,88,2455,1003
2020-11-17,29,4,56,89,4183,2312
2020-11-18,44,8,56,108,5003,1226
2020-11-19,27,6,47,80,3553,1283
2020-11-20,36,8,59,103,3287,2222
2020-11-21,31,5,57,93,4686,2131
2020-11-22,32,2,66,100,4632,1706
2020-11-23,43,8,87,138,8143,3528
2020-11-24,47,12,83,142,7366,1978
2020-11-25,30,8,78,116,6554,1429
2020-11-26,36,3,61,100,5436,1470
2020-11-27,23,7,45,75,2973,848
2020-11-28,34,3,48,85,2501,897
2020-11-29,34,5,44,83,3627,1217
2020-11-30,28,8,65,101,4421,1797
2020-12-01,41,3,85,129,5368,1936
2020-12-02,22,9,64,95,4968,1407
2020-12-03,34,10,55,99,3250,1515
2020-12-04,37,8,66,111,4758,1317
2020-12-05,21,7,56,84,3390,1099
2020-12-06,26,14,51,91,2814,950
2020-12-07,36,5,60,101,4207,1174
2020-12-08,33,7,58,98,3057,1014
2020-12-09,27,3,55,85,2148,1017
2020-12-10,24,5,59,88,4527,929
2020-12-11,22,5,56,83,4873,724
2020-12-12,37,3,48,88,5397,849
2020-12-13,14,7,48,69,3871,884
2020-12-14,23,5,57,85,3759,1020
2020-12-15,32,4,47,83,3438,1376
2020-12-16,36,7,63,106,4881,2055
2020-12-17,30,8,77,115,4714,2296
2020-12-18,22,10,64,96,4886,1392
2020-12-19,34,8,59,101,5555,1461
2020-12-20,28,7,75,110,5908,1582
2020-12-21,25,8,80,113,6894,1773
2020-12-22,31,6,67,104,7524,1249
2020-12-23,34,7,68,109,5060,1365
2020-12-24,32,7,58,97,3017,1262
2020-12-25,20,4,40,64,2857,1327
2020-12-26,29,9,55,93,6232,1745
2020-12-27,34,9,76,119,6290,2536
2020-12-28,36,9,75,120,4775,2036
2020-12-29,28,6,81,115,6077,2043
2020-12-30,24,6,90,120,6247,2063
2020-12-31,27,9,88,124,6250,1562
2021-01-01,41,11,66,118,7035,2030
2021-01-02,37,13,78,128,8637,2661
2021-01-03,84,21,156,261,10147,6720
2021-01-04,76,15,165,256,14091,4765
2021-01-05,63,11,147,221,12404,3867
2021-01-06,62,18,174,254,14434,4739
2021-01-07,74,17,137,228,10486,4448
2021-01-08,58,12,173,243,10646,3348
2021-01-09,55,21,125,201,9627,4100
2021-01-10,69,7,175,251,12208,4094
2021-01-11,67,16,143,226,9681,4333
2021-01-12,48,14,143,205,9189,3188
2021-01-13,38,11,127,176,9556,2413
2021-01-14,49,10,136,195,10943,2935
2021-01-15,59,14,146,219,12612,3049
2021-01-16,48,10,121,179,7035,2818
2021-01-17,40,15,117,172,9571,2658
2021-01-18,64,12,119,195,12335,3151
2021-01-19,90,23,206,319,12708,4756
2021-01-20,76,19,177,272,12293,3408
2021-01-21,64,9,161,234,11312,3782
2021-01-22,51,21,137,209,15254,3372
2021-01-23,38,9,110,157,10047,2302
2021-01-24,37,7,121,165,10784,3721
2021-01-25,76,16,153,245,12817,2784
2021-01-26,59,11,144,214,14368,2710
2021-01-27,72,23,163,258,10911,3723
2021-01-28,123,25,180,328,9872,4169
2021-01-29,262,36,277,575,21143,4480
2021-01-30,179,37,274,490,21900,4430
2021-01-31,150,43,229,422,15439,2697
2021-02-01,133,29,238,400,15468,2734
2021-02-02,188,41,330,559,25299,5731
2021-02-03,186,41,353,580,25944,6059
2021-02-04,181,46,328,555,27378,5673
2021-02-05,205,54,339,598,22485,5727
2021-02-06,122,35,264,421,20747,3567
2021-02-07,139,37,275,451,19731,4632
2021-02-08,133,27,317,477,25388,5859
2021-02-09,142,37,356,535,24722,6003
2021-02-10,123,33,335,491,23812,4842
2021-02-11,117,39,291,447,21239,4354
2021-02-12,127,25,245,397,19466,4401
2021-02-13,112,15,255,382,20413,3469
2021-02-14,101,34,230,365,19002,4134
2021-02-15,111,25,270,406,25319,4176
2021-02-16,89,27,279,395,20747,5263
2021-02-17,107,33,285,425,20575,4772
2021-02-18,175,46,307,528,24550,5183
2021-02-19,161,43,320,524,30455,6901
2021-02-20,175,37,295,507,22859,5109
2021-02-21,132,40,252,424,24545,4440
2021-02-22,153,45,340,538,28800,5413
2021-02-23,141,39,355,535,29114,5542
2021-02-24,111,28,290,429,24844,5177
2021-02-25,122,29,293,444,17219,4046
2021-02-26,130,30,295,455,22601,5255
2021-02-27,112,36,216,364,22218,4527
2021-02-28,157,38,253,448,20746,5327
2021-03-01,96,14,221,331,14368,3798
2021-03-02,96,33,241,370,15312,3037
2021-03-03,114,35,219,368,13930,2987
2021-03-04,80,32,241,353,17796,3110
2021-03-05,100,29,196,325,17952,2776
2021-03-06,93,32,249,374,17916,3230
2021-03-07,96,18,225,339,16373,3391
2021-03-08,104,14,242,360,19501,3492
2021-03-09,113,17,254,384,17313,3867
2021-03-10,110,32,245,387,16237,3032
2021-03-11,99,20,205,324,18488,3029
2021-03-12,76,25,210,311,18608,3671
2021-03-13,102,26,228,356,14955,4193
2021-03-14,100,40,234,374,18933,3104
2021-03-15,85,20,172,277,12834,2849
2021-03-16,125,31,261,417,18086,4833
2021-03-17,86,21,262,369,18355,2957
2021-03-18,87,30,261,378,19554,2733
2021-03-19,80,21,212,313,16108,2572
2021-03-20,92,21,222,335,17471,4064
2021-03-21,97,40,190,327,19400,3108
2021-03-22,75,28,260,363,17111,4305
2021-03-23,85,24,196,305,18445,2671
2021-03-24,89,24,214,327,18032,3002
2021-03-25,89,23,171,283,15490,3200
2021-03-26,92,15,185,292,15841,2685
2021-03-27,74,17,184,275,15547,2229
2021-03-28,84,12,175,271,17111,2629
2021-03-29,107,20,197,324,18518,3200
2021-03-30,71,11,176,258,19392,3355
2021-03-31,108,20,207,335,15836,4391
2021-04-01,134,34,218,386,18935,3754
2021-04-02,168,20,262,450,23301,5244
2021-04-03,102,16,210,328,20672,3129
2021-04-04,90,30,202,322,16363,2925
2021-04-05,94,32,199,325,16421,3650
2021-04-06,89,24,203,316,14418,3512
2021-04-07,113,25,256,394,19624,3678
2021-04-08,122,16,210,348,18820,2765
2021-04-09,97,17,225,339,18098,2964
2021-04-10,113,19,194,326,18294,2928
2021-04-11,92,20,182,294,15654,3413
2021-04-12,143,25,220,388,18603,4594
2021-04-13,120,28,271,419,20043,4928
2021-04-14,194,36,265,495,30062,6104
2021-04-15,191,42,310,543,23201,5804
2021-04-16,154,37,224,415,22319,4470
2021-04-17,125,22,220,367,15216,3455
2021-04-18,174,34,237,445,15246,4207
2021-04-19,126,25,254,405,18930,3812
2021-04-20,159,25,297,481,22466,4152
2021-04-21,156,31,292,479,25320,4409
2021-04-22,193,48,283,524,24853,6809
2021-04-23,169,39,281,489,22710,4466
2021-04-24,127,32,227,386,22990,3471
2021-04-25,150,28,286,464,20343,3955
2021-04-26,167,29,287,483,26311,5575
2021-04-27,156,26,262,444,19027,5153
2021-04-28,190,35,287,512,24867,5321
2021-04-29,176,35,289,500,22688,5481
2021-04-30,141,27,268,436,21694,4750
2021-05-01,190,32,269,491,20394,5678
2021-05-02,167,30,246,443,20490,6591
2021-05-03,366,74,475,915,30011,10377
2021-05-04,270,68,353,691,28523,7759
2021-05-05,196,37,296,529,24270,6806
2021-05-06,180,33,310,523,25312,6844
2021-05-07,194,22,264,480,17819,5541
2021-05-08,213,54,308,575,19653,7729
2021-05-09,209,43,345,597,23426,6757
2021-05-10,333,73,474,880,33923,8934
2021-05-11,197,37,376,610,32271,6899
2021-05-12,272,58,508,838,43357,9922
2021-05-13,262,57,431,750,40949,10516
2021-05-14,190,36,320,546,30832,6465
2021-05-15,146,26,270,442,21037,4967
2021-05-16,187,48,315,550,25159,6904
2021-05-17,203,40,328,571,30643,6353
2021-05-18,156,26,292,474,27231,5576
2021-05-19,404,77,424,905,37252,10424
2021-05-20,197,44,305,546,26502,6346
2021-05-21,188,33,265,486,27129,6269
2021-05-22,130,32,208,370,19163,4464
2021-05-23,191,57,254,502,23115,6573
2021-05-24,173,41,233,447,17955,4870
2021-05-25,144,34,248,426,20163,4341
2021-05-26,105,28,259,392,20237,3696
2021-05-27,116,18,193,327,19727,3741
2021-05-28,89,19,180,288,11849,3046
2021-05-29,107,31,174,312,12790,3331
2021-05-30,92,20,165,277,18377,3053
2021-05-31,101,21,165,287,16906,2413
2021-06-01,93,22,192,307,16149,3232
2021-06-02,80,24,178,282,14234,3116
2021-06-03,123,20,198,341,16481,3542
2021-06-04,102,34,173,309,18080,2914
2021-06-05,71,14,182,267,13007,2676
2021-06-06,89,12,154,255,14768,2966
2021-06-07,97,24,182,303,15781,2740
2021-06-08,96,24,163,283,12333,3179
2021-06-09,109,21,180,310,16710,3027
2021-06-10,89,17,185,291,14024,2555
2021-06-11,68,17,166,251,12620,2866
2021-06-12,76,15,143,234,11990,1743
2021-06-13,79,17,129,225,13534,1950
2021-06-14,126,26,177,329,14111,2438
2021-06-15,90,22,133,245,14716,2124
2021-06-16,79,22,130,231,14210,2331
2021-06-17,84,19,148,251,13059,2433
2021-06-18,84,23,156,263,13125,2457
2021-06-19,67,19,149,235,12111,2012
2021-06-20,78,28,108,214,13126,2130
2021-06-21,118,29,156,303,17934,3924
2021-06-22,125,28,158,311,12823,3606
2021-06-23,76,13,154,243,12624,2950
2021-06-24,66,9,149,224,12834,2062
2021-06-25,83,21,134,238,11593,2652
2021-06-26,85,19,127,231,10524,2866
2021-06-27,78,18,112,208,12017,2340
2021-06-28,73,20,134,227,11878,2845
2021-06-29,83,19,152,254,12716,2788
2021-06-30,89,11,123,223,13320,2205
2021-07-01,87,5,158,250,11051,2175
2021-07-02,60,12,160,232,9093,1956
2021-07-03,68,12,119,199,10244,1461
2021-07-04,63,19,142,224,8559,1836
2021-07-05,76,15,159,250,8655,1607
2021-07-06,78,21,174,273,10125,2212
2021-07-07,100,10,165,275,10108,2424
2021-07-08,91,11,180,282,13765,2240
2021-07-09,81,20,153,254,11696,2440
2021-07-10,67,18,134,219,8553,3326
2021-07-11,39,12,106,157,7320,1899
2021-07-12,66,15,165,246,11299,2529
2021-07-13,75,19,177,271,9785,2859
2021-07-14,75,19,155,249,9637,2331
2021-07-15,70,26,142,238,8812,2333
2021-07-16,67,16,122,205,6550,1641
2021-07-17,81,12,113,206,9621,1627
2021-07-18,68,18,115,201,8694,1789
2021-07-19,80,21,147,248,10725,2203
2021-07-20,87,23,160,270,9760,2952
2021-07-21,76,20,134,230,10516,2664
2021-07-22,81,19,165,265,9152,2771
2021-07-23,75,13,122,210,9335,2234
2021-07-24,49,19,91,159,7584,1953
2021-07-25,64,19,116,199,7757,2045
2021-07-26,120,24,145,289,11196,3279
2021-07-27,76,28,160,264,9083,2727
2021-07-28,73,16,162,251,9357,2394
2021-07-29,66,21,163,250,8908,2216
2021-07-30,85,29,151,265,11169,2938
2021-07-31,90,32,141,263,9633,3868
2021-08-01,107,31,144,282,11112,2871
2021-08-02,90,25,164,279,9214,3270
2021-08-03,101,24,151,276,9919,2113
2021-08-04,109,27,188,324,10006,3644
2021-08-05,206,38,345,589,19428,6234
2021-08-06,141,24,228,393,13822,4339
2021-08-07,149,36,230,415,14087,4981
2021-08-08,115,14,187,316,12904,3999
2021-08-09,105,27,173,305,14569,3558
2021-08-10,110,23,200,333,12630,3648
2021-08-11,108,29,214,351,14638,3839
2021-08-12,115,14,182,311,13867,3991
2021-08-13,96,20,173,289,11690,4122
2021-08-14,99,12,161,272,13361,3111
2021-08-15,101,10,166,277,13656,3114
2021-08-16,89,12,201,302,13007,4851
2021-08-17,96,13,197,306,15081,2516
2021-08-18,78,19,162,259,10649,2889
2021-08-19,106,20,168,294,10662,3659
2021-08-20,95,19,171,285,16682,3250
2021-08-21,79,16,140,235,16079,3561
2021-08-22,73,28,179,280,16492,5075
2021-08-23,91,27,181,299,18877,4435
2021-08-24,91,12,179,282,19744,4038
2021-08-25,81,16,184,281,14397,4461
2021-08-26,88,16,185,289,18518,4790
2021-08-27,83,19,175,277,16462,3582
2021-08-28,51,26,156,233,11964,3415
2021-08-29,62,21,162,245,15746,2640
2021-08-30,83,20,188,291,16004,3679
2021-08-31,85,14,173,272,15713,3820
2021-09-01,139,39,271,449,18746,6141
2021-09-02,121,17,221,359,16369,4378
2021-09-03,144,28,218,390,18556,4780
2021-09-04,67,17,155,239,13063,3299
2021-09-05,91,19,184,294,16533,3966
2021-09-06,97,15,198,310,16272,3845
2021-09-07,124,23,244,391,17008,4339
2021-09-08,84,17,265,366,19619,4395
2021-09-09,74,16,227,317,17487,4652
2021-09-10,52,8,195,255,13869,5261
2021-09-11,64,8,205,277,14206,3768
2021-09-12,61,14,194,269,19418,5770
2021-09-13,64,12,197,273,16396,3526
2021-09-14,70,8,198,276,18261,4765
2021-09-15,72,6,198,276,12538,3319
2021-09-16,56,8,195,259,12530,2818
2021-09-17,46,8,156,210,11465,2919
2021-09-18,46,7,153,206,9299,2485
2021-09-19,47,7,144,198,11359,2642
2021-09-20,66,7,227,300,17905,3769
2021-09-21,62,8,188,258,10664,3289
2021-09-22,61,13,189,263,12077,3144
2021-09-23,51,6,178,235,13358,3089
2021-09-24,61,12,175,248,11184,2889
2021-09-25,40,5,139,184,11070,1966
2021-09-26,43,3,121,167,9521,2802
2021-09-27,53,4,173,230,12209,2713
2021-09-28,47,7,191,245,11113,3162
2021-09-29,47,5,168,220,9431,3033
2021-09-30,63,5,169,237,15577,2644
2021-10-01,48,7,164,219,9980,2907
2021-10-02,49,5,119,173,10129,2106
2021-10-03,53,6,158,217,11546,2193
2021-10-04,58,6,175,239,10548,2827
2021-10-05,63,7,177,247,10738,3549
2021-10-06,56,8,182,246,10933,2919
2021-10-07,52,3,159,214,7857,2806
2021-10-08,47,8,201,256,13399,2561
2021-10-09,47,5,184,236,10528,2218
2021-10-10,44,7,142,193,9103,2754
2021-10-11,53,9,179,241,11372,2804
2021-10-12,53,8,204,265,12331,3159
2021-10-13,43,5,191,239,5714,2847
2021-10-14,74,6,220,300,12042,3382
2021-10-15,63,8,224,295,13779,3909
2021-10-16,50,5,199,254,12331,2946
2021-10-17,53,7,166,226,9410,2465
2021-10-18,57,12,209,278,12793,3443
2021-10-19,66,3,202,271,11829,3097
2021-10-20,97,5,259,361,12177,4664
2021-10-21,95,6,254,355,12976,4435
2021-10-22,82,5,235,322,14633,3348
2021-10-23,54,10,175,239,9818,2260
2021-10-24,60,8,135,203,10638,2247
2021-10-25,71,4,191,266,16889,3081
2021-10-26,63,5,207,275,20686,3196
2021-10-27,54,7,221,282,15258,3287
2021-10-28,71,5,209,285,12644,3980
2021-10-29,107,10,256,373,13908,5312
2021-10-30,85,9,240,334,15813,5102
2021-10-31,60,3,203,266,11749,4383
2021-11-01,75,11,199,285,12335,4318
2021-11-02,100,12,312,424,14596,6611
2021-11-03,95,7,270,372,16137,5554
2021-11-04,77,10,213,300,15971,4144
2021-11-05,63,7,200,270,15533,3638
2021-11-06,48,8,210,266,13832,4213
2021-11-07,80,10,199,289,14759,5255
2021-11-08,129,18,242,389,15339,6020
2021-11-09,111,16,267,394,18832,7526
2021-11-10,102,9,251,362,16217,12733
2021-11-11,96,12,224,332,16129,4998
2021-11-12,73,14,220,307,17619,3597
2021-11-13,54,13,202,269,13221,2847
2021-11-14,85,15,186,286,16672,4273
2021-11-15,72,13,233,318,16196,4306
2021-11-16,94,16,236,346,17255,5704
2021-11-17,79,6,229,314,21563,4075
2021-11-18,109,14,222,345,16767,5206
2021-11-19,80,11,226,317,16095,4218
2021-11-20,60,9,185,254,11265,3645
2021-11-21,73,17,190,280,19709,4645
2021-11-22,70,5,170,245,18032,4146
2021-11-23,73,10,172,255,11773,3752
2021-11-24,57,20,213,290,13797,3174
2021-11-25,69,6,176,251,11174,4680
2021-11-26,78,9,197,284,11904,3527
2021-11-27,78,11,180,269,13703,3616
2021-11-28,73,11,164,248,10817,2719
2021-11-29,82,8,171,261,11765,4355
2021-11-30,104,14,201,319,15072,5696
2021-12-01,90,7,198,295,10265,5463
2021-12-02,97,15,202,314,14262,3977
2021-12-03,80,10,180,270,13192,4466
2021-12-04,114,15,187,316,12539,5702
2021-12-05,82,8,138,228,12614,3578
2021-12-06,83,14,175,272,14111,5058
2021-12-07,79,7,243,329,12601,3621
2021-12-08,72,12,200,284,10663,4388
2021-12-09,52,12,175,239,8466,3520
2021-12-10,70,10,206,286,14193,3930
2021-12-11,66,10,152,228,11968,3705
2021-12-12,56,9,163,228,10629,3791
2021-12-13,63,8,198,269,15240,4851
2021-12-14,56,13,187,256,10674,3416
2021-12-15,75,12,164,251,11063,3980
2021-12-16,59,9,167,235,12692,4933
2021-12-17,43,10,140,193,9092,6604
2021-12-18,53,13,133,199,8184,3639
2021-12-19,59,12,119,190,11060,3004
2021-12-20,55,3,151,209,10804,4067
2021-12-21,69,9,163,241,11329,3261
2021-12-22,80,8,163,251,10865,4252
2021-12-23,49,9,149,207,9141,3168
2021-12-24,73,10,131,214,15310,4176
2021-12-25,68,8,101,177,6806,3244
2021-12-26,51,11,114,176,8966,3403
2021-12-27,49,11,161,221,11014,3944
2021-12-28,52,10,168,230,8661,3302
2021-12-29,55,7,176,238,11084,3315
2021-12-30,66,11,165,242,9613,3492
2021-12-31,53,5,108,166,7617,2441
2022-01-01,41,6,103,150,7882,4182
2022-01-02,43,13,157,213,10367,4042
2022-01-03,59,8,196,263,13306,3827
2022-01-04,47,9,186,242,13281,4250
2022-01-05,72,12,208,292,10880,4341
2022-01-06,72,13,167,252,10698,4879
2022-01-07,72,12,182,266,12793,5031
2022-01-08,71,6,165,242,10707,4365
2022-01-09,79,17,146,242,10710,4155
2022-01-10,58,17,168,243,10432,4488
2022-01-11,82,13,165,260,11318,3261
2022-01-12,57,10,149,216,10011,3322
2022-01-13,74,7,160,241,13259,3442
2022-01-14,51,8,175,234,12047,3470
2022-01-15,42,8,116,166,10939,2780
2022-01-16,47,4,118,169,8525,2767
2022-01-17,59,12,149,220,11672,3558
2022-01-18,47,11,156,214,9470,3143
2022-01-19,69,7,146,222,9841,3403
2022-01-20,85,9,131,225,14471,6231
2022-01-21,73,18,194,285,9604,5419
2022-01-22,86,24,164,274,9478,6047
2022-01-23,56,11,136,203,8358,3296
2022-01-24,55,15,182,252,11190,5297
2022-01-25,49,8,147,204,10499,3194
2022-01-26,60,10,101,171,8959,3871
2022-01-27,49,9,135,193,9090,3654
2022-01-28,65,12,148,225,7765,3644
2022-01-29,45,4,120,169,10854,3806
2022-01-30,47,15,139,201,10981,6469
2022-01-31,56,11,123,190,11748,3762
2022-02-01,43,13,144,200,9116,4272
2022-02-02,46,7,172,225,8061,3176
2022-02-03,35,11,159,205,8272,3385
2022-02-04,51,13,122,186,8286,3077
2022-02-05,55,11,119,185,8156,2773
2022-02-06,45,11,140,196,8322,3138
2022-02-07,62,7,172,241,13004,3695
2022-02-08,59,9,152,220,11792,2821
2022-02-09,66,8,149,223,10535,3258
2022-02-10,45,6,137,188,6504,2479
2022-02-11,50,8,144,202,8921,2653
2022-02-12,40,12,115,167,6123,2327
2022-02-13,49,7,127,183,6604,2195
2022-02-14,48,14,133,195,6318,1929
2022-02-15,51,5,129,185,10677,2239
2022-02-16,41,9,150,200,9498,1973
2022-02-17,35,5,154,194,7546,1891
2022-02-18,52,6,160,218,7042,1753
2022-02-19,54,4,122,180,6417,1286
2022-02-20,38,15,109,162,7919,1540
2022-02-21,54,15,127,196,7479,2232
2022-02-22,69,7,141,217,12690,2320
2022-02-23,53,10,166,229,13168,2377
2022-02-24,72,11,140,223,8470,3346
2022-02-25,45,7,121,173,7314,2023
2022-02-26,49,8,125,182,7762,1684
2022-02-27,35,11,131,177,9864,1889
2022-02-28,31,4,131,166,7819,1732
2022-03-01,59,7,150,216,6806,1803
2022-03-02,49,7,130,186,8935,1676
2022-03-03,43,10,130,183,7073,1788
2022-03-04,53,15,122,190,5142,2035
2022-03-05,49,4,76,129,4467,3753
2022-03-06,39,7,93,139,6083,1494
2022-03-07,44,9,102,155,6293,1536
2022-03-08,53,8,114,175,6824,2045
2022-03-09,46,6,96,148,6459,1894
2022-03-10,35,14,109,158,6996,2312
2022-03-11,41,8,109,158,5936,1964
2022-03-12,50,7,101,158,5131,1676
2022-03-13,35,7,72,114,4702,1208
2022-03-14,44,8,87,139,4652,1651
2022-03-15,44,16,104,164,4890,1748
2022-03-16,76,7,92,175,6773,2940
2022-03-17,67,12,115,194,7163,2367
2022-03-18,46,11,88,145,5100,2018
2022-03-19,53,6,90,149,6254,1435
2022-03-20,50,9,90,149,9613,2683
2022-03-21,44,7,90,141,6163,2940
2022-03-22,68,7,89,164,6008,2748
2022-03-23,72,13,101,186,6010,1932
2022-03-24,52,8,92,152,6585,2134
2022-03-25,42,15,104,161,7746,1627
2022-03-26,59,13,82,154,7392,1906
2022-03-27,62,12,89,163,5330,2207
2022-03-28,98,16,131,245,10276,2841
2022-03-29,46,13,106,165,9264,3734
2022-03-30,51,17,111,179,9227,2126
2022-03-31,43,24,132,199,9609,3201
2022-04-01,64,16,114,194,9376,2667
2022-04-02,52,8,116,176,9923,2916
2022-04-03,39,13,82,134,4957,1897
2022-04-04,59,12,92,163,6364,2582
2022-04-05,54,9,121,184,6604,2511
2022-04-06,48,10,119,177,10300,2302
2022-04-07,53,7,94,154,5043,1902
2022-04-08,43,17,117,177,9511,3277
2022-04-09,22,12,91,125,4834,2096
2022-04-10,41,4,78,123,9642,2038
2022-04-11,54,9,76,139,7381,2788
2022-04-12,52,13,85,150,6297,3065
2022-04-13,52,11,101,164,9428,3639
2022-04-14,50,17,105,172,7843,3270
2022-04-15,35,9,105,149,5533,2802
2022-04-16,58,7,99,164,6642,2593
2022-04-17,31,12,107,150,4983,3170
2022-04-18,41,12,114,167,6941,3116
2022-04-19,45,13,135,193,9239,4063
2022-04-20,35,10,129,174,7916,3083
2022-04-21,36,9,158,203,9331,2944
2022-04-22,46,12,154,212,8117,2138
2022-04-23,39,4,95,138,5282,1358
2022-04-24,26,5,93,124,7466,1300
2022-04-25,36,10,101,147,7675,2316
2022-04-26,33,4,101,138,6308,2005
2022-04-27,44,7,111,162,8480,1754
2022-04-28,49,17,113,179,11028,2883
2022-04-29,43,9,107,159,7417,2289
2022-04-30,30,9,83,122,6100,2086
2022-05-01,50,14,81,145,5713,1967
2022-05-02,47,6,78,131,6132,1739
2022-05-03,34,3,93,130,9116,2582
2022-05-04,44,9,108,161,7658,2103
2022-05-05,38,12,72,122,4982,1655
2022-05-06,40,20,106,166,8991,2278
2022-05-07,30,10,77,117,4641,1785
2022-05-08,33,11,86,130,8278,2346
2022-05-09,43,23,103,169,7288,3852
2022-05-10,58,14,113,185,7234,3049
2022-05-11,59,21,122,202,9625,4704
2022-05-12,83,17,128,228,7494,4617
2022-05-13,41,13,102,156,5489,2826
2022-05-14,70,10,75,155,9948,2423
2022-05-15,54,14,103,171,7509,2420
2022-05-16,40,6,126,172,7945,2224
2022-05-17,53,12,129,194,8716,2157
2022-05-18,80,11,120,211,9602,2490
2022-05-19,59,13,84,156,8669,2157
2022-05-20,45,7,72,124,9111,2047
2022-05-21,58,7,63,128,4636,1640
2022-05-22,60,6,67,133,6940,2090
2022-05-23,47,9,72,128,9088,2436
2022-05-24,47,1,88,136,7554,2326
2022-05-25,31,8,78,117,5430,1721
2022-05-26,30,8,83,121,7382,2717
2022-05-27,38,7,65,110,6046,2369
2022-05-28,29,7,56,92,5740,1822
2022-05-29,26,13,44,83,5029,1235
2022-05-30,23,9,67,99,5013,844
2022-05-31,32,4,74,110,7621,2117
2022-06-01,22,3,40,65,6824,945
2022-06-02,30,5,69,104,6365,1653
2022-06-03,34,6,66,106,6712,1913
2022-06-04,31,6,74,111,5407,1451
2022-06-05,23,7,80,110,4296,1439
2022-06-06,33,8,85,126,5860,2071
2022-06-07,47,5,79,131,6724,2033
2022-06-08,27,8,67,102,4056,1973
2022-06-09,23,5,67,95,4913,1719
2022-06-10,28,7,50,85,7807,2465
2022-06-11,38,15,68,121,4807,3647
2022-06-12,33,6,51,90,6412,3423
2022-06-13,59,30,100,189,11670,6385
2022-06-14,47,11,75,133,4752,3282
2022-06-15,40,13,81,134,6308,3640
2022-06-16,27,13,78,118,4849,3029
2022-06-17,61,7,90,158,10400,2838
2022-06-18,50,10,55,115,4579,4433
2022-06-19,41,14,66,121,7111,2649
2022-06-20,46,7,84,137,5545,2661
2022-06-21,31,11,66,108,5539,2095
2022-06-22,26,10,71,107,6824,2483
2022-06-23,29,5,72,106,4777,2092
2022-06-24,42,3,70,115,6017,2004
2022-06-25,29,3,47,79,3035,1620
2022-06-26,19,2,37,58,3646,1719
2022-06-27,33,6,47,86,6017,1961
2022-06-28,37,5,67,109,5857,1917
2022-06-29,27,7,44,78,13202,1813
2022-06-30,24,6,54,84,4554,1602
2022-07-01,32,9,67,108,7344,1982
2022-07-02,23,4,49,76,2448,1223
2022-07-03,24,3,36,63,3518,1098
2022-07-04,26,9,35,70,3859,1130
2022-07-05,30,2,55,87,3802,1727
2022-07-06,29,6,54,89,4780,1835
2022-07-07,29,4,50,83,4035,1499
2022-07-08,23,5,58,86,5585,1690
2022-07-09,13,5,26,44,4045,1260
2022-07-10,29,5,51,85,3276,1762
2022-07-11,21,9,56,86,3908,2064
2022-07-12,40,3,68,111,4527,1480
2022-07-13,38,2,68,108,6781,1639
2022-07-14,31,6,71,108,6013,1906
2022-07-15,25,2,49,76,3451,2144
2022-07-16,35,7,55,97,4753,1814
2022-07-17,18,6,49,73,3731,1397
2022-07-18,34,6,66,106,5763,2927
2022-07-19,38,4,67,109,5273,2478
2022-07-20,35,8,62,105,4971,2358
2022-07-21,35,6,61,102,6056,1987
2022-07-22,28,9,66,103,5153,2001
2022-07-23,27,4,43,74,4390,1572
2022-07-24,23,5,32,60,3626,1672
2022-07-25,20,6,53,79,5713,1996
2022-07-26,36,4,46,86,3654,2167
2022-07-27,32,5,36,73,3687,1825
2022-07-28,40,6,70,116,5184,2577
2022-07-29,17,5,53,75,4451,1867
2022-07-30,34,1,37,72,2967,1900
2022-07-31,19,4,40,63,4128,1967
2022-08-01,35,4,62,101,5101,1595
2022-08-02,44,1,57,102,7071,1895
2022-08-03,37,4,66,107,3273,2314
2022-08-04,37,3,58,98,4165,1611
2022-08-05,47,8,62,117,5170,1590
2022-08-06,39,8,64,111,5606,2736
2022-08-07,31,6,56,93,5299,2014
2022-08-08,27,2,68,97,3936,2632
2022-08-09,34,10,81,125,5233,2204
2022-08-10,40,3,81,124,6498,2136
2022-08-11,54,7,73,134,7741,2716
2022-08-12,48,8,61,117,6662,2473
2022-08-13,51,7,65,123,5658,2395
2022-08-14,43,3,46,92,3737,1740
2022-08-15,37,5,43,85,3756,1611
2022-08-16,46,7,63,116,6395,2166
2022-08-17,51,6,72,129,5631,2150
2022-08-18,32,9,77,118,6729,1825
2022-08-19,33,3,55,91,6762,1820
2022-08-20,26,6,52,84,4477,1643
2022-08-21,17,3,58,78,5268,1377
2022-08-22,31,1,55,87,4259,1487
2022-08-23,36,4,59,99,7927,1722
2022-08-24,39,4,47,90,4513,1283
2022-08-25,54,6,76,136,8341,2639
2022-08-26,76,4,65,145,5799,2019
2022-08-27,31,7,52,90,3439,1505
2022-08-28,33,4,56,93,4119,1221
2022-08-29,33,7,62,102,6221,1238
2022-08-30,58,9,76,143,9494,2112
2022-08-31,40,7,52,99,4476,2008
2022-09-01,37,6,54,97,3896,1484
2022-09-02,29,8,46,83,5161,1581
2022-09-03,29,4,47,80,2958,1144
2022-09-04,25,9,34,68,2172,1012
2022-09-05,37,4,59,100,5079,1954
2022-09-06,49,5,57,111,5266,2476
2022-09-07,46,8,65,119,6193,2201
2022-09-08,21,0,52,73,4333,1767
2022-09-09,40,3,64,107,5441,1522
2022-09-10,31,9,54,94,3951,1817
2022-09-11,29,4,64,97,3351,1577
2022-09-12,30,3,72,105,4546,2581
2022-09-13,35,6,81,122,4768,2124
2022-09-14,58,7,84,149,6729,6345
2022-09-15,136,29,175,340,13203,8690
2022-09-16,47,18,124,189,7887,4094
2022-09-17,34,13,100,147,5811,2619
2022-09-18,26,40,51,117,4322,3326
2022-09-19,28,21,67,116,6626,2299
2022-09-20,23,13,61,97,7785,2179
2022-09-21,28,13,51,92,5488,2263
2022-09-22,23,8,52,83,4168,2290
2022-09-23,17,4,47,68,3974,1809
2022-09-24,22,4,33,59,3234,1147
2022-09-25,32,4,60,96,4147,1684
2022-09-26,23,11,32,66,4891,1813
2022-09-27,21,4,42,67,1957,1423
2022-09-28,25,1,30,56,2975,1279
2022-09-29,18,3,37,58,2949,1619
2022-09-30,12,3,29,44,1540,987
2022-10-01,20,5,43,68,3271,1197
2022-10-02,10,1,30,41,1848,828
2022-10-03,15,3,44,62,2039,1115
2022-10-04,20,2,35,57,3255,1343
2022-10-05,30,3,43,76,3321,1324
2022-10-06,18,1,37,56,3309,1417
2022-10-07,13,5,15,33,2169,945
2022-10-08,14,3,25,42,2571,723
2022-10-09,17,3,22,42,1444,614
2022-10-10,19,4,29,52,2339,773
2022-10-11,20,3,32,55,3087,864
2022-10-12,18,3,39,60,4231,985
2022-10-13,13,1,34,48,2367,1173
2022-10-14,13,1,32,46,4738,1067
2022-10-15,11,2,31,44,1529,725
2022-10-16,15,1,27,43,2591,797
2022-10-17,17,0,35,52,4501,939
2022-10-18,27,1,37,65,3251,739
2022-10-19,22,0,30,52,3122,948
2022-10-20,16,1,39,56,6814,1038
2022-10-21,12,3,20,35,2632,716
2022-10-22,11,2,39,52,3037,857
2022-10-23,8,2,21,31,1715,666
2022-10-24,20,1,41,62,1537,971
2022-10-25,21,4,30,55,2925,1293
2022-10-26,25,1,42,68,2051,1477
2022-10-27,28,6,42,76,3006,743
2022-10-28,24,1,37,62,2613,753
2022-10-29,18,5,34,57,4268,1242
2022-10-30,22,2,28,52,2608,621
2022-10-31,29,4,51,84,4311,819
2022-11-01,23,2,29,54,3007,964
2022-11-02,29,2,40,71,3179,1009
2022-11-03,20,4,49,73,4871,1101
2022-11-04,15,1,28,44,2034,1153
2022-11-05,9,0,35,44,1479,678
2022-11-06,7,0,37,44,1757,823
2022-11-07,20,5,43,68,5026,1191
2022-11-08,24,5,34,63,2513,2469
2022-11-09,27,5,59,91,3329,2711
2022-11-10,24,1,51,76,2685,2708
2022-11-11,38,3,41,82,3382,2393
2022-11-12,35,1,54,90,11057,1873
2022-11-13,25,7,35,67,2424,1414
2022-11-14,19,3,51,73,4352,2013
2022-11-15,25,4,43,72,3689,1579
2022-11-16,25,0,47,72,3307,1675
2022-11-17,40,2,61,103,3137,1679
2022-11-18,23,3,66,92,4022,1786
2022-11-19,16,2,57,75,2621,1244
2022-11-20,11,2,30,43,2269,1068
2022-11-21,24,2,46,72,3321,1740
2022-11-22,17,2,48,67,1805,1183
2022-11-23,26,1,69,96,5555,1343
2022-11-24,19,2,59,80,2652,1032
2022-11-25,16,2,36,54,1813,989
2022-11-26,10,2,40,52,1424,783
2022-11-27,14,1,48,63,1727,946
2022-11-28,18,5,53,76,3355,1087
2022-11-29,20,0,41,61,1366,764
2022-11-30,22,3,40,65,4163,1070
2022-12-01,19,1,35,55,4069,1002
2022-12-02,14,3,28,45,1353,856
2022-12-03,19,4,27,50,3723,488
2022-12-04,14,3,17,34,1590,1051
2022-12-05,16,3,46,65,3270,699
2022-12-06,25,4,62,91,4568,767
2022-12-07,20,2,66,88,2977,1157
2022-12-08,25,2,61,88,2910,1051
2022-12-09,19,4,50,73,6487,1010
2022-12-10,11,3,46,60,1530,802
2022-12-11,213,4,362,579,10543,2485
2022-12-12,139,1,171,311,6845,1059
2022-12-13,29,3,40,72,2873,862
2022-12-14,28,2,44,74,2550,850
2022-12-15,23,5,99,127,2875,988
2022-12-16,35,3,77,115,2361,1206
2022-12-17,15,2,44,61,1810,977
2022-12-18,49,2,27,78,2173,1109
2022-12-19,23,5,42,70,1700,584
2022-12-20,38,3,54,95,2348,646
2022-12-21,321,1,112,434,9176,1180
2022-12-22,20,2,45,67,4270,1353
2022-12-23,145,1,76,222,4526,778
2022-12-24,12,1,21,34,1676,1004
2022-12-25,9,2,25,36,926,822
2022-12-26,19,2,31,52,3080,751
2022-12-27,21,5,42,68,1597,960
2022-12-28,24,2,29,55,3233,1020
2022-12-29,19,1,31,51,4161,879
2022-12-30,10,2,21,33,1714,539
2022-12-31,9,2,19,30,1732,920
