posted_on,positive_count,negative_count,neutral_count,total_posts,total_words,total_stopwords,total_comments,average_word_length,mean_vader_score
2019-01-01,11,1,25,37,2068,838,750,6.196415694524111,0.23392162162162164
2019-01-02,19,3,59,81,3005,1137,1502,6.615711336121492,0.19111975308641976
2019-01-03,24,4,59,87,3850,1446,1192,6.966657640265976,0.20958275862068965
2019-01-04,13,2,48,63,1805,675,1293,6.364461658866519,0.2063698412698413
2019-01-05,17,2,52,71,2634,995,1053,6.545904688708524,0.2238323943661972
2019-01-06,15,1,33,49,1862,711,905,6.387683091815317,0.2785285714285714
2019-01-07,21,4,60,85,7376,2646,1087,6.438590751970858,0.19829176470588236
2019-01-08,33,5,43,81,8297,3210,1204,6.465215916649389,0.3049444444444444
2019-01-09,21,4,41,66,4068,1659,923,6.256584924971865,0.2602151515151515
2019-01-10,17,3,61,81,1793,564,1486,6.4111561484278,0.08664938271604938
2019-01-11,17,2,50,69,4865,1981,1106,6.842567553172363,0.22103478260869566
2019-01-12,16,2,24,42,1884,644,674,7.016031075107171,0.27126428571428574
2019-01-13,15,5,39,59,7362,2741,1003,6.487031239482407,0.1547050847457627
2019-01-14,30,6,64,100,7706,2966,1176,6.754438988347199,0.237276
2019-01-15,25,3,47,75,6023,2269,1986,6.634598031550634,0.2651346666666667
2019-01-16,17,4,48,69,7057,2666,835,7.437887322905253,0.18680000000000002
2019-01-17,24,1,49,74,4200,1535,910,6.3917993641539494,0.2922945945945946
2019-01-18,21,2,40,63,3479,1375,1094,7.0652634658219196,0.2943904761904762
2019-01-19,18,0,32,50,3169,1226,593,6.286027768296991,0.335648
2019-01-20,13,0,20,33,1853,707,711,6.192027198679062,0.39672727272727276
2019-01-21,24,7,34,65,5234,2135,934,6.305877119293844,0.2968569230769231
2019-01-22,20,3,44,67,4496,1784,1881,6.609503969825309,0.26164029850746273
2019-01-23,36,5,48,89,4813,1801,1638,6.453541812139972,0.3469415730337079
2019-01-24,31,4,232,267,5813,2030,1392,6.8527085395068665,0.08727303370786517
2019-01-25,25,1,41,67,4852,1911,884,6.504694531364119,0.3460298507462687
2019-01-26,13,0,21,34,1024,317,394,7.413514563055262,0.30313529411764706
2019-01-27,11,1,23,35,2205,944,819,6.772571431968454,0.28529714285714286
2019-01-28,14,5,145,164,4399,1668,1216,6.896291360779351,0.13801219512195123
2019-01-29,21,4,135,160,3187,1119,705,7.513175629961505,0.243356875
2019-01-30,22,4,42,68,5965,2470,1041,6.559942345649544,0.30583823529411763
2019-01-31,31,1,46,78,7306,2789,875,6.52097834765919,0.3827858974358974
2019-02-01,14,2,39,55,3757,1459,694,6.550997232412336,0.26432
2019-02-02,15,2,32,49,3224,1327,545,6.561566046374207,0.2605081632653061
2019-02-03,13,1,22,36,1693,534,396,6.381563073222225,0.31908888888888887
2019-02-04,25,1,29,55,8136,2791,689,6.563865684997707,0.4512
2019-02-05,18,2,40,60,3495,1307,722,6.7517229243225865,0.258455
2019-02-06,33,3,36,72,5502,2325,1038,6.544901171721296,0.3736138888888889
2019-02-07,36,0,49,85,7206,2489,1017,6.709812963921046,0.36585529411764706
2019-02-08,18,1,21,40,1925,721,1100,6.439334851442579,0.3850475
2019-02-09,8,1,24,33,1954,779,724,6.5678183625732744,0.21076969696969697
2019-02-10,14,3,22,39,2215,804,783,6.734962550482275,0.27155641025641025
2019-02-11,18,3,41,62,3311,1198,806,6.443355784542138,0.21369677419354838
2019-02-12,13,2,35,50,2762,1069,757,6.40753502335331,0.23893599999999998
2019-02-13,27,1,37,65,5458,2183,1048,6.456911701868715,0.3801323076923077
2019-02-14,13,5,30,48,3291,1232,622,6.409190476744186,0.18938750000000001
2019-02-15,31,0,17,48,4674,1826,887,6.430020343716741,0.5661625
2019-02-16,11,4,26,41,2578,1018,707,6.523968512333095,0.19735121951219511
2019-02-17,11,1,32,44,2531,988,1369,6.328256135295343,0.24793863636363636
2019-02-18,27,2,54,83,4802,1834,2414,6.507889293113646,0.278366265060241
2019-02-19,35,8,52,95,8678,3559,1454,6.484999055005343,0.28217157894736844
2019-02-20,34,5,45,84,7283,2597,1435,6.484891529415865,0.3133988095238095
2019-02-21,18,3,37,58,4220,1645,987,6.842198691772133,0.27281724137931035
2019-02-22,18,2,48,68,2837,1031,976,7.172143644721056,0.2418529411764706
2019-02-23,12,1,28,41,2423,936,1625,6.376216591446844,0.33996585365853654
2019-02-24,14,2,23,39,2047,780,1617,6.56826684873141,0.26332307692307694
2019-02-25,23,1,26,50,8373,3430,1436,6.369012056614029,0.40182
2019-02-26,15,2,31,48,4364,1587,783,6.796582290534359,0.2639708333333333
2019-02-27,14,7,35,56,2324,850,1078,6.908481256164842,0.13005
2019-02-28,28,2,43,73,4285,1641,1372,6.434412839403433,0.32995479452054793
2019-03-01,23,1,39,63,4187,1712,1027,7.108763667988461,0.33802063492063494
2019-03-02,6,1,23,30,761,291,572,6.457523711014718,0.2194566666666667
2019-03-03,10,0,16,26,1858,733,614,6.274774999263313,0.3429076923076923
2019-03-04,18,1,40,59,3433,1378,932,6.255524143276066,0.29873898305084745
2019-03-05,36,1,37,74,6649,2414,918,6.461158650242342,0.4105635135135135
2019-03-06,31,2,38,71,3922,1316,1009,6.268242595425879,0.35186056338028165
2019-03-07,20,2,36,58,3258,1242,828,6.556540404369033,0.2959568965517242
2019-03-08,21,4,34,59,4453,1606,1252,6.432236007140943,0.2563152542372881
2019-03-09,14,0,19,33,2835,1158,810,6.729653599929965,0.36822727272727274
2019-03-10,17,2,16,35,6685,1739,485,6.414947509469035,0.41461714285714285
2019-03-11,21,2,25,48,4307,1664,991,7.090210391616721,0.31873333333333337
2019-03-12,24,2,40,66,4739,1901,703,6.562895769815052,0.3066121212121212
2019-03-13,28,2,34,64,3997,1552,822,6.609374080000533,0.3387890625
2019-03-14,35,2,29,66,9177,3680,765,6.512202140421234,0.468769696969697
2019-03-15,15,4,25,44,3100,1144,753,6.362030300719994,0.2936636363636364
2019-03-16,11,1,25,37,2482,996,576,6.446911077413296,0.2419
2019-03-17,17,1,12,30,4917,1975,717,6.45874170281714,0.5051066666666667
2019-03-18,23,0,27,50,4082,1679,664,6.385058262248288,0.35126399999999997
2019-03-19,22,4,35,61,4770,1885,1189,6.349844034885918,0.31205409836065573
2019-03-20,23,3,49,75,4865,1906,707,6.585729950952924,0.291644
2019-03-21,23,0,21,44,4988,2065,911,6.528585184062347,0.5191931818181819
2019-03-22,19,0,33,52,4440,1775,890,6.363221316045422,0.3449365384615385
2019-03-23,7,1,27,35,933,305,510,6.703313266639363,0.18706285714285714
2019-03-24,9,3,21,33,1580,591,573,6.815669438326573,0.19762727272727273
2019-03-25,13,2,26,41,1493,559,676,6.341326045792797,0.2832
2019-03-26,18,4,26,48,4541,1759,870,6.544420511344228,0.25375
2019-03-27,22,1,35,58,5631,2151,851,6.5359988992686615,0.33653793103448276
2019-03-28,29,0,35,64,3730,1429,823,6.510893015096111,0.414021875
2019-03-29,18,2,29,49,4081,1682,1081,6.5407926834300625,0.3275938775510204
2019-03-30,10,2,20,32,1703,607,666,6.531831053414558,0.243475
2019-03-31,14,2,18,34,3950,1562,586,6.602906409822002,0.3471764705882353
2019-04-01,18,1,45,64,3099,1190,1275,6.511495354883091,0.2361140625
2019-04-02,19,4,26,49,4494,1598,2584,6.817355466580762,0.2928857142857143
2019-04-03,24,2,41,67,4089,1584,2743,6.518097619973226,0.29105223880597014
2019-04-04,24,1,34,59,4878,1871,1289,6.311528125995415,0.34187457627118645
2019-04-05,13,0,41,54,2274,858,1298,6.486547544376489,0.23080185185185187
2019-04-06,5,1,19,25,832,299,788,6.445787699185862,0.251304
2019-04-07,7,0,24,31,1005,389,1267,6.3435924743610625,0.2686483870967742
2019-04-08,14,3,29,46,2331,917,1464,6.578184130761147,0.30539347826086954
2019-04-09,34,3,34,71,5863,2413,1165,6.390232930168401,0.38874788732394366
2019-04-10,21,1,29,51,2513,910,1589,6.429557062037089,0.3565058823529412
2019-04-11,16,2,29,47,2481,966,1433,6.291564303351109,0.35208085106382975
2019-04-12,13,1,27,41,1553,556,1221,6.322778462349791,0.26781707317073167
2019-04-13,20,2,11,33,2593,1063,825,5.967902491346598,0.43696969696969695
2019-04-14,10,3,24,37,2227,778,813,6.259774906682467,0.18538648648648648
2019-04-15,13,4,21,38,7660,3187,1045,6.219278017218645,0.24510526315789474
2019-04-16,22,1,42,65,3262,1073,1080,7.162169404496178,0.30408153846153846
2019-04-17,19,4,28,51,2946,1210,1794,6.515126797728344,0.2901607843137255
2019-04-18,20,2,33,55,3773,1413,1229,6.4524445723636825,0.3165309090909091
2019-04-19,9,2,32,43,1510,545,888,6.689339837250169,0.18547906976744186
2019-04-20,12,3,18,33,2037,821,859,6.628456031790037,0.2521424242424243
2019-04-21,12,2,18,32,1717,656,653,6.016258990993923,0.2147875
2019-04-22,13,0,24,37,1775,704,829,6.488370981093326,0.31404324324324323
2019-04-23,12,3,25,40,2655,1054,1164,6.05856499011752,0.2871725
2019-04-24,16,1,36,53,2655,1062,1702,6.502193759154642,0.25286792452830187
2019-04-25,16,1,45,62,2924,1128,1568,6.4981992035628675,0.29495967741935486
2019-04-26,17,4,20,41,4185,1776,1076,6.314603021357253,0.2817170731707317
2019-04-27,13,1,24,38,2788,1201,836,6.8418304632441505,0.3373157894736842
2019-04-28,10,5,23,38,2883,901,664,6.5116297644650505,0.1609157894736842
2019-04-29,17,0,22,39,3450,1379,770,6.400881094202895,0.39530000000000004
2019-04-30,19,0,45,64,4129,1608,897,7.003520931166303,0.28263125
2019-05-01,13,5,29,47,4267,1740,848,6.528759902575276,0.21446595744680852
2019-05-02,24,3,36,63,3309,1276,983,6.376427427421253,0.281463492063492
2019-05-03,32,1,39,72,3727,1488,1329,6.604742256223432,0.37935972222222225
2019-05-04,12,3,23,38,2319,909,820,6.14677658385655,0.21252368421052628
2019-05-05,7,0,25,32,915,332,538,8.104224404263945,0.207075
2019-05-06,17,1,45,63,3011,1194,1440,6.4955024648836,0.23465238095238095
2019-05-07,14,0,28,42,3174,1268,1287,6.388974663094178,0.3529857142857143
2019-05-08,16,3,40,59,3576,1416,1292,6.2734028904799715,0.22855932203389828
2019-05-09,20,1,30,51,2687,1001,1316,6.67997031064564,0.3706078431372549
2019-05-10,19,4,29,52,2078,742,1219,6.4858563362790145,0.27181730769230766
2019-05-11,14,2,26,42,2167,885,2517,5.987452213204293,0.27257380952380955
2019-05-12,12,1,28,41,1463,580,964,6.359781491201645,0.2615365853658536
2019-05-13,18,3,48,69,2505,915,2050,6.435221660960921,0.2501115942028985
2019-05-14,21,1,52,74,4674,1826,2281,6.57564155193404,0.3100932432432432
2019-05-15,19,5,46,70,5417,2220,4574,6.245149806388714,0.2413457142857143
2019-05-16,27,2,53,82,5351,2103,2535,6.304429016729918,0.3230682926829268
2019-05-17,20,2,39,61,3281,1242,1353,6.487483962525241,0.29237704918032786
2019-05-18,11,1,26,38,2023,751,968,6.344465973484879,0.21478684210526314
2019-05-19,18,5,35,58,4586,1758,1192,6.453993794111787,0.2694396551724138
2019-05-20,18,3,21,42,4375,1727,887,6.1902665828628605,0.3228714285714286
2019-05-21,25,0,49,74,2838,1082,1654,6.44509071431063,0.2793675675675676
2019-05-22,18,2,47,67,2433,932,1203,6.487312151093391,0.2344776119402985
2019-05-23,21,3,44,68,3239,1208,977,6.357183431930313,0.28605147058823527
2019-05-24,22,2,28,52,1689,563,965,6.025301888422368,0.32426538461538457
2019-05-25,18,7,18,43,1783,685,812,6.271455598610297,0.26088372093023254
2019-05-26,16,3,15,34,2716,1083,1333,5.913333697511316,0.3178970588235294
2019-05-27,19,3,20,42,4629,1835,1247,6.3194676154828455,0.36141428571428574
2019-05-28,18,1,37,56,2270,858,1419,6.466168239250678,0.3041125
2019-05-29,17,6,30,53,3602,1446,1473,6.284304465602145,0.18995849056603772
2019-05-30,16,3,41,60,1999,741,1761,6.413908283237955,0.19501333333333332
2019-05-31,16,0,32,48,1735,645,1202,6.627959997872011,0.2931229166666667
2019-06-01,13,0,27,40,1858,686,784,6.445654850479022,0.3104175
2019-06-02,15,3,24,42,1754,623,779,6.286008075134462,0.29525
2019-06-03,18,2,36,56,2363,955,1130,6.4039492032043706,0.2997107142857143
2019-06-04,22,0,36,58,2729,1019,913,6.4534786625628335,0.32377241379310345
2019-06-05,11,4,30,45,2032,799,891,7.195514724357975,0.1610711111111111
2019-06-06,14,0,28,42,1079,371,892,6.1455038461426845,0.30612142857142854
2019-06-07,13,3,37,53,2603,999,875,6.295435644201239,0.16396037735849056
2019-06-08,11,0,31,42,3843,1389,581,6.401696646613896,0.25934285714285715
2019-06-09,6,0,21,27,1064,337,728,6.383439761732642,0.1578
2019-06-10,14,5,38,57,3510,1314,1344,6.361688187733109,0.21993684210526315
2019-06-11,16,0,28,44,2708,1066,911,6.38202297145202,0.34939545454545456
2019-06-12,14,5,37,56,4143,1609,1509,6.730114946047999,0.14285892857142857
2019-06-13,19,0,45,64,3359,1220,1064,6.608580315149361,0.2761171875
2019-06-14,14,2,31,47,1943,709,1186,6.759816204645893,0.175631914893617
2019-06-15,13,1,18,32,1876,755,959,6.435997287129001,0.3835375
2019-06-16,6,3,20,29,477,145,877,6.5439326133430695,0.16114137931034483
2019-06-17,13,1,31,45,1843,680,1312,6.225969042581503,0.2616111111111111
2019-06-18,29,7,45,81,5174,2068,1955,6.443106740699405,0.2849864197530864
2019-06-19,27,3,39,69,6999,2708,1135,6.3550477070239815,0.32662318840579707
2019-06-20,15,2,37,54,3606,1310,1446,6.552035253955826,0.2681074074074074
2019-06-21,26,5,35,66,2843,1072,2913,6.372632997634182,0.2711212121212121
2019-06-22,19,2,40,61,3161,1248,2096,6.251863633519668,0.22911311475409835
2019-06-23,14,1,27,42,1727,613,1355,6.003551449600467,0.24510238095238096
2019-06-24,17,1,47,65,3332,1312,1401,6.465572962398505,0.3243538461538461
2019-06-25,17,5,37,59,2742,1029,2252,6.057166588302618,0.20528644067796611
2019-06-26,22,2,59,83,3186,1220,3657,6.231567939633119,0.25228313253012047
2019-06-27,16,3,49,68,2456,909,1994,6.288686554066463,0.21318970588235295
2019-06-28,11,3,30,44,4449,1765,1522,6.565798326161997,0.22875227272727272
2019-06-29,4,2,18,24,1065,452,1079,6.12595420048504,0.13742083333333335
2019-06-30,7,3,22,32,1583,558,895,6.047782545672383,0.14559375000000002
2019-07-01,11,2,34,47,2252,931,1093,6.29025132586645,0.19399148936170213
2019-07-02,17,0,22,39,2138,835,1233,6.134254010448167,0.3452
2019-07-03,12,2,33,47,2489,989,1217,6.294907675144727,0.18759574468085108
2019-07-04,26,0,32,58,2561,924,800,6.392321041289683,0.3204586206896552
2019-07-05,15,0,20,35,3367,1382,822,6.299829686548877,0.3735342857142857
2019-07-06,4,0,23,27,1220,502,654,6.514488314120159,0.2129074074074074
2019-07-07,5,0,20,25,1502,578,766,6.650941884183825,0.175764
2019-07-08,16,5,28,49,3302,1268,953,6.406619983791772,0.25564285714285717
2019-07-09,12,0,38,50,3512,1386,1575,6.418016877934638,0.261574
2019-07-10,14,4,34,52,3104,1191,1742,6.358139044542744,0.21596923076923075
2019-07-11,14,0,36,50,3747,1430,1273,6.386752267718164,0.250634
2019-07-12,8,2,31,41,2497,960,850,6.3037628037880955,0.13902439024390245
2019-07-13,4,2,30,36,746,241,749,6.377629027200105,0.08976111111111111
2019-07-14,8,3,29,40,1674,532,1817,6.307101547872053,0.16298249999999997
2019-07-15,12,2,50,64,2586,993,1692,6.574688449689441,0.2086234375
2019-07-16,14,2,32,48,1884,650,2357,6.415649515745145,0.21452708333333334
2019-07-17,17,2,35,54,4833,1839,1485,6.270548873887269,0.2466537037037037
2019-07-18,16,2,49,67,1762,628,1048,6.420997180707627,0.1901955223880597
2019-07-19,11,1,25,37,5001,2072,882,6.282208675570712,0.2267783783783784
2019-07-20,14,0,31,45,1527,567,1019,6.450344770384566,0.23728
2019-07-21,11,1,11,23,834,298,485,5.89129815556381,0.3018521739130435
2019-07-22,22,2,26,50,3959,1709,921,6.215408039592009,0.317664
2019-07-23,23,6,24,53,4820,1788,1051,6.47779961881852,0.3059
2019-07-24,22,2,33,57,3019,1147,977,6.243534144079565,0.2984614035087719
2019-07-25,20,1,36,57,4288,1718,798,6.587639099651848,0.28973157894736845
2019-07-26,15,3,23,41,2817,1155,759,6.781535681881715,0.2283878048780488
2019-07-27,17,0,34,51,1758,629,628,6.543783118122327,0.25424901960784313
2019-07-28,5,0,27,32,930,342,604,6.625676813928694,0.17142812500000001
2019-07-29,17,1,23,41,4511,1959,947,6.464776409140555,0.3862926829268293
2019-07-30,11,3,21,35,3572,667,674,6.74240630000575,0.21568857142857142
2019-07-31,19,0,38,57,1922,676,915,6.419641969168034,0.3073947368421053
2019-08-01,8,0,19,27,678,233,840,6.47650202179816,0.23456296296296295
2019-08-02,11,1,35,47,1358,525,900,6.690871612182525,0.1905744680851064
2019-08-03,22,1,21,44,2564,979,543,6.6633142527301,0.3249136363636364
2019-08-04,11,0,21,32,697,241,676,6.542686592421262,0.262053125
2019-08-05,16,2,32,50,1757,648,1215,6.51659436664045,0.236356
2019-08-06,14,2,29,45,3022,1193,1155,6.390135419804515,0.23736888888888888
2019-08-07,18,1,40,59,2567,1068,1569,7.002247683248422,0.26921525423728815
2019-08-08,20,1,29,50,4532,1985,1124,6.408026033896752,0.308178
2019-08-09,21,1,28,50,1977,762,1460,6.786779181059691,0.3306
2019-08-10,17,3,16,36,1097,419,618,7.230228371898779,0.21929722222222223
2019-08-11,12,2,14,28,3782,1796,810,6.754194190756669,0.288325
2019-08-12,17,0,32,49,2065,583,642,6.758183164718329,0.2957
2019-08-13,28,2,29,59,2394,947,835,6.701242069915232,0.34665254237288134
2019-08-14,29,1,30,60,3734,1415,1720,6.551044912201239,0.385575
2019-08-15,20,1,42,63,985,266,1170,6.299025766200384,0.2531253968253968
2019-08-16,16,2,30,48,1999,709,860,6.734909902777118,0.26368541666666667
2019-08-17,9,1,27,37,1531,572,789,6.091696207797758,0.20511081081081078
2019-08-18,12,2,25,39,1709,587,2958,7.017066781673548,0.22729743589743587
2019-08-19,29,3,46,78,9948,4134,1055,6.767607067250926,0.33094871794871794
2019-08-20,22,1,46,69,7233,3108,1414,7.911582636472525,0.2904666666666667
2019-08-21,15,2,29,46,3694,1515,1998,6.71133719837364,0.2929
2019-08-22,17,1,37,55,2198,828,1144,6.530248004529753,0.21889818181818183
2019-08-23,18,1,38,57,4155,1618,1236,6.561441936643775,0.2931736842105263
2019-08-24,10,2,28,40,4043,1670,1171,6.281540480772731,0.22475
2019-08-25,14,0,16,30,1746,716,739,6.604581225811842,0.3847433333333333
2019-08-26,11,1,35,47,4962,1776,871,6.514787166118086,0.2235574468085106
2019-08-27,21,3,26,50,2961,1126,832,6.381622727447675,0.33528199999999997
2019-08-28,11,4,20,35,3226,1329,1344,6.495526309533651,0.20246285714285714
2019-08-29,14,3,31,48,3168,1217,1089,7.096795948115997,0.2520145833333333
2019-08-30,15,0,21,36,2265,873,662,6.536760034014625,0.38694999999999996
2019-08-31,10,0,17,27,2441,911,536,6.336796316245318,0.2844851851851852
2019-09-01,14,0,18,32,2152,835,603,6.297894296522307,0.326315625
2019-09-02,7,3,20,30,1394,532,605,6.148955621901597,0.11445
2019-09-03,20,2,31,53,4932,1891,925,6.4030122637534275,0.33869811320754717
2019-09-04,14,1,37,52,2061,755,907,6.6781205013777045,0.2964788461538462
2019-09-05,16,2,34,52,4559,1867,1359,6.640141822889394,0.29700000000000004
2019-09-06,21,0,19,40,3847,1362,761,6.470827031237294,0.48088499999999995
2019-09-07,8,0,18,26,985,344,596,7.357484380865843,0.2731923076923077
2019-09-08,7,1,22,30,1492,572,389,6.442674772059563,0.18377333333333334
2019-09-09,17,0,26,43,3168,1215,675,6.154615399634446,0.36745581395348836
2019-09-10,15,2,22,39,2954,1118,682,6.780052023964059,0.2842
2019-09-11,16,0,25,41,1800,691,711,6.829915318572726,0.32506341463414634
2019-09-12,20,0,40,60,3322,1215,744,6.194160548177743,0.28113333333333335
2019-09-13,9,1,20,30,2138,805,658,6.228467486000332,0.26445
2019-09-14,18,1,17,36,1312,450,699,6.177407797704742,0.4514083333333333
2019-09-15,10,3,24,37,2481,995,825,6.141413700100598,0.1691054054054054
2019-09-16,18,1,28,47,3558,1428,1081,6.252347681611084,0.3612340425531915
2019-09-17,14,2,25,41,3017,1203,1671,6.181498024662279,0.27681463414634144
2019-09-18,21,1,31,53,4786,1897,970,6.310814021524567,0.3733867924528302
2019-09-19,11,0,42,53,1540,487,1278,7.211919106094087,0.19329622641509434
2019-09-20,22,2,30,54,5186,1969,1155,6.4933706290511495,0.31367592592592597
2019-09-21,11,0,21,32,2169,906,539,6.757341794615705,0.300746875
2019-09-22,12,1,14,27,3073,1330,614,7.331297571013276,0.36758148148148145
2019-09-23,19,1,28,48,3145,1268,975,6.697559810190789,0.34912916666666666
2019-09-24,22,0,24,46,3782,1472,1776,6.47528729167523,0.4161847826086957
2019-09-25,16,4,27,47,3830,1551,989,7.437299874416758,0.22613617021276597
2019-09-26,15,2,14,31,2910,1147,1192,6.401796456880991,0.36232580645161294
2019-09-27,24,1,25,50,2427,899,801,6.296190039402806,0.447668
2019-09-28,7,0,12,19,1605,665,366,7.498520549661986,0.2903
2019-09-29,16,3,24,43,2943,1178,463,6.264961612493275,0.2373953488372093
2019-09-30,9,2,27,38,1621,545,607,6.381699167328816,0.16767631578947367
2019-10-01,11,2,30,43,3683,1488,574,6.314169118364697,0.2491139534883721
2019-10-02,24,2,28,54,4154,1605,561,6.384339581589176,0.3806407407407408
2019-10-03,4,0,20,24,642,190,536,8.38905440982163,0.16562083333333333
2019-10-04,14,0,30,44,2196,659,710,6.764731596376968,0.30454318181818185
2019-10-05,10,1,22,33,1757,632,369,6.65684829408878,0.23702424242424244
2019-10-06,6,1,13,20,571,188,414,6.610918612788178,0.243655
2019-10-07,12,1,22,35,2648,1022,660,6.33349949445883,0.29433714285714285
2019-10-08,14,0,34,48,1818,643,544,6.400159672992507,0.25788125
2019-10-09,20,2,23,45,3869,1592,1111,6.339110387922374,0.41682222222222226
2019-10-10,14,7,39,60,2141,736,781,6.407679262093555,0.1655
2019-10-11,10,3,24,37,2946,1228,607,6.590949826780668,0.2070810810810811
2019-10-12,22,3,24,49,1918,749,533,6.405555506822933,0.3607673469387755
2019-10-13,7,0,12,19,1083,428,398,6.610960036899886,0.3862684210526316
2019-10-14,10,4,20,34,1375,479,522,6.359140121347015,0.21480588235294118
2019-10-15,12,4,31,47,2679,1063,685,8.382641691889386,0.18462553191489361
2019-10-16,14,2,22,38,1023,330,635,6.43359219287523,0.28500789473684207
2019-10-17,9,3,20,32,2348,937,646,6.367528075870816,0.220278125
2019-10-18,8,1,26,35,1755,604,405,6.627238031096754,0.23457142857142854
2019-10-19,5,4,18,27,929,303,486,6.0366405582636515,0.05051851851851851
2019-10-20,11,2,19,32,2003,706,321,6.236824974523677,0.287840625
2019-10-21,11,0,24,35,1684,642,703,6.682972022870009,0.29514285714285715
2019-10-22,15,2,22,39,3021,991,676,6.672791541856925,0.291374358974359
2019-10-23,19,3,23,45,3159,1254,1020,6.662294154153958,0.37256
2019-10-24,8,2,27,37,1795,683,527,7.37312266692321,0.20138108108108108
2019-10-25,8,1,23,32,2031,831,1102,6.380402251532673,0.21669375
2019-10-26,9,0,12,21,1073,421,539,5.970587158361794,0.4046142857142857
2019-10-27,3,0,13,16,675,196,441,6.228193563233456,0.2594125
2019-10-28,12,3,29,44,2967,1061,546,6.234544232185699,0.22005
2019-10-29,11,1,21,33,1063,353,475,6.5069294932078705,0.2853787878787879
2019-10-30,11,2,23,36,1639,647,466,6.231159160857399,0.21361666666666668
2019-10-31,20,0,24,44,4310,1739,654,6.131087120795654,0.39013636363636367
2019-11-01,8,1,19,28,1371,528,401,6.018553832776279,0.21154285714285712
2019-11-02,2,4,12,18,544,190,218,6.0923175975259305,-0.000422222222222222
2019-11-03,5,3,11,19,1631,657,472,6.393533537237785,0.2086684210526316
2019-11-04,13,3,29,45,2475,923,700,6.557364492516838,0.2890244444444444
2019-11-05,8,0,37,45,2807,1099,485,6.51705146709026,0.21604
2019-11-06,16,1,27,44,2857,1148,762,6.35560111132796,0.28755681818181816
2019-11-07,15,1,26,42,1366,487,615,5.981834346710044,0.3825404761904762
2019-11-08,12,0,22,34,1456,531,518,6.26735577297394,0.34457941176470586
2019-11-09,7,0,15,22,831,305,322,6.319544139282001,0.3377318181818182
2019-11-10,5,2,15,22,3578,1545,311,6.297465320536623,0.17754545454545456
2019-11-11,12,3,21,36,2071,810,454,6.4345597070557385,0.23968611111111113
2019-11-12,14,1,19,34,1426,494,337,6.61819931963609,0.2787705882352941
2019-11-13,13,0,19,32,2332,932,577,6.297806252636411,0.38513437500000003
2019-11-14,16,1,16,33,2671,1006,501,7.052104968347296,0.42842121212121215
2019-11-15,8,1,22,31,2544,990,553,6.466150133243299,0.20795483870967743
2019-11-16,7,0,11,18,707,284,225,6.175852266596612,0.3921277777777778
2019-11-17,13,2,19,34,2747,929,378,6.074687522899488,0.28041764705882355
2019-11-18,10,2,20,32,1027,416,454,6.3424672803198385,0.218484375
2019-11-19,14,0,20,34,1888,720,447,6.301294110016113,0.3688911764705883
2019-11-20,11,0,27,38,1881,705,818,6.710439761942332,0.3127473684210526
2019-11-21,14,1,44,59,2389,915,1025,6.177147218163168,0.21022542372881356
2019-11-22,8,3,22,33,1040,399,1099,6.566044856046918,0.1264060606060606
2019-11-23,10,1,19,30,1735,645,364,6.5999556992620745,0.22865
2019-11-24,7,0,20,27,1126,455,591,6.418056875810959,0.21837777777777778
2019-11-25,14,3,30,47,2799,1056,698,6.084902171470185,0.2787340425531915
2019-11-26,24,3,30,57,4012,1645,516,6.477123035947936,0.31794912280701754
2019-11-27,19,3,32,54,3286,1150,632,6.43142807647741,0.2721074074074074
2019-11-28,15,0,16,31,1134,402,335,6.943834364872686,0.3793064516129032
2019-11-29,13,1,20,34,1514,552,445,6.099648940038783,0.2841470588235294
2019-11-30,11,2,24,37,1554,534,317,6.285197091230347,0.19610540540540541
2019-12-01,7,3,25,35,1649,661,389,6.3049533035905725,0.13293428571428573
2019-12-02,8,3,15,26,1400,566,435,6.350305984380149,0.26665
2019-12-03,14,6,33,53,2770,1100,614,6.43490975596919,0.152288679245283
2019-12-04,14,3,26,43,2809,1080,2122,6.319808982441616,0.23059069767441862
2019-12-05,14,1,38,53,3626,1484,558,7.107708429200044,0.22457169811320754
2019-12-06,16,2,16,34,1978,741,649,6.5342702580568846,0.3353529411764706
2019-12-07,11,0,23,34,1178,413,517,6.4398193944684206,0.22693823529411766
2019-12-08,8,4,22,34,1607,613,501,6.325254468071676,0.19714705882352943
2019-12-09,9,6,29,44,1410,509,558,5.96617280354366,0.09741818181818183
2019-12-10,16,4,50,70,4215,1692,486,6.604982113451626,0.17928
2019-12-11,11,2,34,47,1443,526,677,7.547704916846945,0.17064042553191489
2019-12-12,14,1,25,40,2635,1036,516,8.065230619637706,0.33591
2019-12-13,11,2,33,46,1707,586,368,6.195756118449323,0.21195652173913043
2019-12-14,8,6,16,30,1950,760,692,6.091646270434466,0.06710666666666668
2019-12-15,12,3,20,35,3482,1545,562,6.561182357249921,0.2345685714285714
2019-12-16,11,2,32,45,1703,585,1097,6.391119281434492,0.19216
2019-12-17,11,3,22,36,2297,828,1061,6.476188819768749,0.3083666666666667
2019-12-18,16,4,27,47,2505,975,1053,6.3111237154258,0.23931063829787236
2019-12-19,19,4,44,67,4355,1704,604,6.305495188451996,0.2535044776119403
2019-12-20,10,3,28,41,1588,515,431,6.620775087914779,0.17593170731707317
2019-12-21,4,0,33,37,892,296,483,6.0564211927764315,0.0799918918918919
2019-12-22,10,0,9,19,1042,403,5815,6.167093618440522,0.42591052631578946
2019-12-23,9,1,22,32,4396,1502,635,6.1456318738085285,0.2215
2019-12-24,3,3,16,22,458,157,348,6.653241695243511,0.07132272727272727
2019-12-25,7,1,19,27,922,329,365,6.2675273941666525,0.1502740740740741
2019-12-26,12,4,26,42,1816,687,561,6.20082580313594,0.1245095238095238
2019-12-27,7,2,20,29,1868,774,438,5.822318785868282,0.20210344827586207
2019-12-28,6,0,29,35,1056,367,283,6.262616675594107,0.1447257142857143
2019-12-29,1,0,13,14,294,114,430,6.5444888709174425,0.07860714285714286
2019-12-30,22,5,49,76,3658,1360,444,6.463491188058015,0.20600789473684208
2019-12-31,4,2,56,62,1142,327,463,6.332653532558505,0.02344354838709677
2020-01-01,9,5,41,55,1197,335,403,6.188271784719887,0.11686545454545455
2020-01-02,8,5,44,57,2140,797,385,6.088202700890925,0.1161421052631579
2020-01-03,15,4,46,65,2083,682,464,6.2917587667926735,0.17369846153846155
2020-01-04,8,7,35,50,2070,766,430,6.116785001481995,0.010396
2020-01-05,11,7,38,56,1295,351,383,6.134768448872605,0.13158571428571428
2020-01-06,8,0,15,23,829,291,511,6.245702702174368,0.2903434782608696
2020-01-07,15,2,29,46,1472,501,646,6.231812277665742,0.2709521739130435
2020-01-08,15,1,33,49,2615,990,585,6.211958275882623,0.288730612244898
2020-01-09,12,2,26,40,1599,588,560,6.322467751534125,0.24559000000000003
2020-01-10,7,1,22,30,1038,358,512,6.245630162790956,0.22843666666666665
2020-01-11,5,1,16,22,1055,438,394,6.385313646123293,0.2506409090909091
2020-01-12,12,1,24,37,1329,514,406,6.593463630123429,0.2557891891891892
2020-01-13,12,3,44,59,2029,765,579,6.168548248240551,0.21689830508474578
2020-01-14,18,3,40,61,3213,1199,1306,6.527676389592777,0.2907032786885246
2020-01-15,11,4,39,54,3842,1465,739,6.592740218425958,0.18597777777777777
2020-01-16,11,2,36,49,1286,430,580,6.648290597203538,0.17210204081632652
2020-01-17,11,4,24,39,3135,1135,933,6.2681815224928945,0.22579487179487182
2020-01-18,14,2,23,39,1997,757,755,6.1976254476545565,0.30806153846153844
2020-01-19,15,0,15,30,1637,573,501,6.297727050896493,0.42697333333333337
2020-01-20,7,1,48,56,1451,454,504,6.537331125812996,0.13470535714285714
2020-01-21,13,3,31,47,2918,1217,428,6.3170742013396115,0.19892127659574468
2020-01-22,17,2,44,63,4159,1688,760,6.292089900970461,0.23517619047619048
2020-01-23,6,1,24,31,675,204,581,6.802306525518307,0.17070645161290324
2020-01-24,9,0,33,42,1721,634,648,6.516379563753725,0.27990714285714285
2020-01-25,7,2,18,27,1395,521,473,6.456772650040523,0.21541111111111114
2020-01-26,4,0,13,17,316,108,460,6.225062536642564,0.2246588235294118
2020-01-27,9,3,32,44,2294,867,723,6.215440199916097,0.18038863636363636
2020-01-28,13,0,36,49,2300,732,634,6.446382941361239,0.26681836734693876
2020-01-29,11,0,31,42,1302,446,644,6.543057531523433,0.271152380952381
2020-01-30,13,2,31,46,1140,387,1197,6.268274752509528,0.2187
2020-01-31,18,1,46,65,2603,946,672,6.472248881093303,0.2804430769230769
2020-02-01,16,1,53,70,2132,747,604,6.505211841926158,0.19488142857142857
2020-02-02,14,8,83,105,2218,560,937,6.4025884177948065,0.08737428571428572
2020-02-03,16,5,91,112,2260,662,970,6.680255297666335,0.10555714285714286
2020-02-04,5,4,53,62,1350,443,617,6.408738956857567,0.0888483870967742
2020-02-05,10,3,25,38,1768,611,2404,6.2657907449308325,0.18567105263157896
2020-02-06,16,0,41,57,4318,1606,1629,6.377563654658768,0.2842877192982456
2020-02-07,22,5,72,99,4521,1718,1286,6.5088974190263595,0.19162626262626262
2020-02-08,11,3,68,82,1689,530,1109,6.4039565468791775,0.13841463414634145
2020-02-09,20,7,59,86,2570,924,1161,6.395053436218527,0.12783023255813955
2020-02-10,15,2,48,65,2019,703,832,6.306621563544696,0.21451846153846155
2020-02-11,14,1,38,53,1626,582,1788,6.143791281373962,0.27368113207547173
2020-02-12,16,2,57,75,2675,1042,3412,6.303224881935672,0.196984
2020-02-13,10,1,58,69,2404,904,1634,6.572517204976469,0.16537391304347826
2020-02-14,7,1,37,45,2031,870,1833,6.427144968375034,0.2351111111111111
2020-02-15,15,4,35,54,1940,762,1409,6.1877209304547875,0.19862962962962966
2020-02-16,12,3,48,63,3965,1499,1200,6.42819645237035,0.1532714285714286
2020-02-17,10,2,52,64,1224,383,1091,6.5832679844079,0.13875
2020-02-18,7,4,53,64,1901,707,1476,6.489712995401872,0.083709375
2020-02-19,15,2,30,47,1650,613,1159,6.385021626223969,0.24481489361702127
2020-02-20,10,3,43,56,2652,959,1093,6.743657226342359,0.21218571428571428
2020-02-21,11,3,44,58,1543,580,916,6.6356269071018055,0.12574655172413793
2020-02-22,10,1,17,28,1826,734,1252,6.3150988238031704,0.2745964285714286
2020-02-23,7,1,21,29,1518,469,1086,6.62023614769645,0.1976103448275862
2020-02-24,8,4,41,53,1241,424,656,6.969207599631546,0.08321698113207548
2020-02-25,12,0,44,56,1660,568,782,6.3274988764033555,0.20143214285714287
2020-02-26,17,2,31,50,2309,875,1227,6.522531187842812,0.25662
2020-02-27,10,1,33,44,1100,355,741,6.809341772500492,0.25224318181818184
2020-02-28,23,4,32,59,4229,1672,688,6.610070342222753,0.31137288135593216
2020-02-29,8,0,23,31,1846,728,511,6.5843075424032484,0.28800000000000003
2020-03-01,9,1,22,32,1064,380,445,6.30121347578077,0.21280000000000002
2020-03-02,14,2,35,51,1835,676,657,6.3158857209394546,0.2038705882352941
2020-03-03,21,1,47,69,3369,1269,645,6.597347046824114,0.2751202898550725
2020-03-04,13,2,40,55,3138,1256,686,6.098098052945545,0.18428363636363637
2020-03-05,13,4,39,56,3123,1289,791,6.443475474666305,0.18170714285714284
2020-03-06,12,2,31,45,1307,466,913,6.716207968238989,0.1959088888888889
2020-03-07,8,1,30,39,1473,604,680,6.996013777198966,0.17858717948717948
2020-03-08,10,1,25,36,1853,705,1018,6.201623183841255,0.290525
2020-03-09,11,2,32,45,3513,788,1089,6.841645819726873,0.22844
2020-03-10,13,1,19,33,2355,915,718,6.238448907381875,0.35743939393939395
2020-03-11,18,0,22,40,2743,1025,862,6.417183033965928,0.40279
2020-03-12,12,6,36,54,3067,1175,4150,6.624583933180368,0.11542592592592592
2020-03-13,13,9,35,57,3166,1147,1628,5.943542586115555,0.07541228070175438
2020-03-14,14,0,23,37,1173,455,1123,6.315031965838907,0.31165405405405405
2020-03-15,7,1,13,21,658,244,833,6.4057721831307814,0.19853809523809524
2020-03-16,4,1,19,24,1369,516,1212,6.332570545112763,0.1809666666666667
2020-03-17,9,1,29,39,1383,512,672,6.278862873118675,0.24269230769230768
2020-03-18,7,0,29,36,1394,555,771,6.338492923940269,0.12687222222222222
2020-03-19,10,2,25,37,1529,586,816,6.22898602490211,0.19174864864864866
2020-03-20,6,1,21,28,1003,326,802,6.023097202682085,0.19185714285714286
2020-03-21,4,1,22,27,852,323,413,6.692671311729895,0.21848148148148147
2020-03-22,6,0,11,17,1894,854,417,6.459118864186563,0.4053176470588235
2020-03-23,11,1,23,35,1281,481,511,6.298365037823489,0.25610571428571427
2020-03-24,13,1,23,37,4052,1377,489,6.533334509456797,0.36838918918918917
2020-03-25,7,2,25,34,2144,739,370,6.457407938020488,0.15825
2020-03-26,13,0,14,27,1020,349,384,6.063972286397485,0.4566925925925926
2020-03-27,9,2,13,24,2259,978,380,6.3160514279882,0.2466
2020-03-28,6,1,24,31,1372,542,370,5.812009722483386,0.18868387096774192
2020-03-29,3,0,12,15,554,196,221,6.577197435686349,0.20428
2020-03-30,11,1,25,37,1015,326,235,6.366374906817186,0.26623243243243244
2020-03-31,14,0,31,45,1834,744,299,6.749922829708008,0.2719111111111111
2020-04-01,15,3,27,45,2974,1179,347,6.197333620966962,0.25650666666666666
2020-04-02,7,0,36,43,1174,417,360,6.479021050568804,0.2093
2020-04-03,9,3,32,44,2969,1219,299,6.562218545699627,0.17778863636363637
2020-04-04,7,1,20,28,626,195,254,6.389955928419943,0.22133571428571427
2020-04-05,8,0,15,23,1093,439,234,6.668865709407324,0.25065652173913044
2020-04-06,15,1,40,56,2967,1117,708,6.253992912226997,0.2627428571428571
2020-04-07,12,2,26,40,1811,645,433,6.096817361053352,0.2106675
2020-04-08,15,3,29,47,3185,1274,482,6.580470614331087,0.24560851063829786
2020-04-09,8,2,33,43,1602,562,408,6.057380222472351,0.17184186046511626
2020-04-10,8,1,29,38,1669,654,369,7.8044861814345925,0.24128947368421053
2020-04-11,6,0,19,25,727,253,310,6.104072679897002,0.237592
2020-04-12,7,1,17,25,1653,689,235,6.357853100312382,0.21290399999999998
2020-04-13,13,4,34,51,3775,1334,400,6.693356330477643,0.2316862745098039
2020-04-14,17,0,32,49,2322,826,292,6.297923914498533,0.31478979591836737
2020-04-15,9,2,23,34,1915,675,400,6.061779044716921,0.2629794117647059
2020-04-16,13,0,37,50,1529,551,577,6.300934184247841,0.256292
2020-04-17,11,0,28,39,1786,730,399,6.0491279551386565,0.2427923076923077
2020-04-18,11,1,32,44,2862,1125,730,6.726468595776264,0.21453181818181816
2020-04-19,13,1,35,49,2251,664,366,6.488109805423894,0.1703387755102041
2020-04-20,17,2,37,56,4202,1705,525,6.313237385673573,0.2506946428571429
2020-04-21,5,3,35,43,2145,770,565,6.307076104726234,0.09921860465116279
2020-04-22,11,1,35,47,1714,550,519,6.353260307043958,0.20937446808510637
2020-04-23,9,2,29,40,1148,378,773,6.340339502819611,0.1800825
2020-04-24,17,0,24,41,1284,467,466,6.3227818819666535,0.30003658536585365
2020-04-25,11,1,24,36,1400,580,617,6.152760745310883,0.2624388888888889
2020-04-26,5,0,23,28,799,263,620,6.438435978476571,0.14069285714285715
2020-04-27,9,1,26,36,2397,941,537,6.163091769493797,0.1897888888888889
2020-04-28,15,2,38,55,1921,678,363,6.204402899544395,0.2321018181818182
2020-04-29,15,2,26,43,2068,820,3,6.243251213585041,0.21951627906976742
2020-04-30,10,0,34,44,1381,488,2,6.100857831964075,0.2142022727272727
2020-05-01,8,0,33,41,1337,506,734,6.323468515323129,0.16563170731707316
2020-05-02,7,0,17,24,1540,606,385,5.867240887878437,0.27795
2020-05-03,6,0,20,26,1752,698,288,6.095503423342094,0.2714884615384615
2020-05-04,11,0,28,39,994,351,387,6.013390271454058,0.17122051282051282
2020-05-05,7,0,34,41,1388,539,479,6.332415163756967,0.17806097560975612
2020-05-06,11,0,27,38,1492,490,593,6.150007783579975,0.2636342105263158
2020-05-07,16,1,38,55,3528,1158,799,6.481666476421562,0.23407818181818182
2020-05-08,15,2,37,54,3500,1398,576,6.1067247588304605,0.30169074074074076
2020-05-09,3,1,17,21,602,196,521,5.980872118118874,0.16227142857142857
2020-05-10,7,2,34,43,1411,560,502,6.427489014552592,0.11489302325581396
2020-05-11,11,0,40,51,1678,605,668,6.129255772868764,0.19946666666666668
2020-05-12,13,8,37,58,1750,622,542,6.244403422570925,0.08360344827586207
2020-05-13,12,1,26,39,3555,1413,716,5.964601197167267,0.24212051282051283
2020-05-14,16,2,33,51,2689,1032,1002,6.28476402139674,0.2861294117647059
2020-05-15,20,0,37,57,3349,1157,726,6.4550405789824135,0.3388473684210526
2020-05-16,10,2,29,41,2902,1185,632,6.351367235877433,0.25115853658536585
2020-05-17,10,0,37,47,1202,425,771,6.245856049240106,0.1738787234042553
2020-05-18,9,3,42,54,2459,927,532,6.2195628589602805,0.17427962962962962
2020-05-19,16,4,30,50,1751,635,840,6.373490503362177,0.24955199999999997
2020-05-20,17,4,48,69,2872,1032,576,6.110301598244033,0.16294927536231882
2020-05-21,10,3,39,52,1726,656,639,6.746914510300855,0.15850576923076923
2020-05-22,18,3,33,54,3235,1201,641,6.015994443074086,0.24578518518518522
2020-05-23,9,2,27,38,3023,1234,563,6.022166970082496,0.1500421052631579
2020-05-24,11,0,29,40,1036,385,455,6.318250683437993,0.2417025
2020-05-25,11,2,52,65,2366,849,535,6.778260898783122,0.13782769230769232
2020-05-26,14,2,55,71,3404,1358,615,6.34762446255159,0.19616478873239437
2020-05-27,8,1,56,65,1815,622,540,6.323880953095759,0.13447076923076923
2020-05-28,8,4,40,52,1581,599,707,6.225237084039761,0.11084807692307692
2020-05-29,6,0,33,39,1620,618,606,6.554540890921297,0.11915128205128206
2020-05-30,7,3,25,35,1270,477,876,6.2647989507424775,0.2031742857142857
2020-05-31,6,6,33,45,800,272,470,6.278217235049409,0.036562222222222225
2020-06-01,15,2,38,55,4017,1644,704,6.40620417438769,0.22314363636363635
2020-06-02,8,2,28,38,1124,395,871,6.216580078174532,0.15791842105263157
2020-06-03,14,1,43,58,3465,1371,792,6.604861228034182,0.2063844827586207
2020-06-04,16,2,31,49,2808,1137,509,6.521097070981857,0.19607142857142856
2020-06-05,8,6,46,60,2470,948,409,6.475938841208871,0.047606666666666665
2020-06-06,4,4,30,38,1072,410,340,6.5584708091969794,0.028947368421052628
2020-06-07,9,2,36,47,3305,1487,451,7.493095137235912,0.10044468085106384
2020-06-08,16,4,29,49,3742,1507,490,6.186742433072039,0.1797408163265306
2020-06-09,14,1,31,46,1862,721,496,6.569939187944565,0.23296739130434782
2020-06-10,13,0,29,42,1981,748,794,6.326824932636395,0.33389761904761905
2020-06-11,4,2,36,42,1295,501,667,6.462858218233368,0.12061190476190475
2020-06-12,4,1,30,35,1024,378,379,6.06206400742115,0.14892
2020-06-13,8,0,28,36,2580,1078,355,6.637054957499568,0.25835555555555556
2020-06-14,14,2,34,50,3667,1552,507,6.151021203068231,0.230914
2020-06-15,5,4,29,38,1108,448,523,6.371871288699052,0.05249736842105263
2020-06-16,15,3,43,61,2259,836,610,6.262363631382511,0.23045081967213116
2020-06-17,18,0,32,50,4378,1659,448,6.525228937095102,0.3492
2020-06-18,17,1,42,60,4135,1646,1257,6.2346968500010815,0.22558333333333333
2020-06-19,16,2,24,42,5391,2190,721,6.266918331518233,0.2855142857142857
2020-06-20,13,0,33,46,2267,816,6612,6.039710890635678,0.2361413043478261
2020-06-21,4,2,22,28,754,270,497,6.3760370915856575,0.07881785714285713
2020-06-22,9,1,40,50,1501,496,815,6.269192219160094,0.217894
2020-06-23,15,0,39,54,2418,997,819,5.926646810355356,0.19642407407407406
2020-06-24,9,2,32,43,2337,937,916,6.309561109487647,0.17432325581395347
2020-06-25,7,1,24,32,1788,641,624,6.0567306056563925,0.1913375
2020-06-26,16,2,25,43,2512,950,581,6.077031520045834,0.35284418604651163
2020-06-27,12,1,25,38,2801,1232,425,6.44709540061933,0.26332894736842105
2020-06-28,5,3,23,31,1897,792,467,6.107258205574093,0.1385741935483871
2020-06-29,9,3,28,40,2672,875,429,6.454068774938659,0.11521250000000001
2020-06-30,12,2,23,37,5938,2517,651,6.518029721822166,0.24146486486486488
2020-07-01,10,1,37,48,1822,669,571,6.273932070628084,0.12740833333333335
2020-07-02,6,1,29,36,978,307,540,6.2583115753247505,0.13411111111111113
2020-07-03,13,2,35,50,2366,938,455,7.56816925156043,0.180436
2020-07-04,5,0,36,41,1904,721,269,6.558595945482111,0.13424634146341463
2020-07-05,6,2,22,30,690,210,274,6.186337965277729,0.11689333333333334
2020-07-06,15,1,47,63,2699,976,764,6.677658755827793,0.19575555555555554
2020-07-07,17,2,34,53,2277,803,601,6.230915504901542,0.26953584905660377
2020-07-08,13,3,36,52,1686,631,750,6.427835169850553,0.21151153846153845
2020-07-09,9,3,33,45,2199,821,949,6.343509159146275,0.09716666666666668
2020-07-10,11,5,23,39,2165,834,540,6.413154092744695,0.14117179487179488
2020-07-11,7,3,24,34,1753,676,411,6.4019350581779095,0.12337058823529412
2020-07-12,6,0,17,23,1007,358,602,6.524255865495178,0.21743043478260868
2020-07-13,12,3,26,41,1084,352,685,6.167119374723842,0.21561707317073173
2020-07-14,11,0,27,38,1181,456,566,6.491389845377988,0.2699947368421053
2020-07-15,5,1,26,32,1708,686,722,6.7279198541068315,0.09088750000000001
2020-07-16,12,3,14,29,1842,588,561,6.246803679500465,0.2590137931034483
2020-07-17,9,1,43,53,1558,554,552,6.436185497917246,0.16403962264150945
2020-07-18,9,0,28,37,937,323,552,6.203544786800305,0.2237162162162162
2020-07-19,9,2,23,34,1511,601,530,6.701356658839153,0.24043529411764708
2020-07-20,15,1,36,52,2968,1152,570,6.109703603462375,0.2302307692307692
2020-07-21,12,0,31,43,2645,1041,696,6.111583833542083,0.2319046511627907
2020-07-22,10,4,37,51,1621,613,1346,6.407224294512689,0.12769411764705882
2020-07-23,8,3,40,51,1171,400,1419,6.108508068547569,0.13365294117647059
2020-07-24,9,4,35,48,1201,390,1353,5.850617497846671,0.16419791666666667
2020-07-25,12,2,44,58,1938,739,2116,6.1366419047707135,0.15993793103448278
2020-07-26,22,4,48,74,2729,1036,2098,6.480191582778417,0.2536891891891892
2020-07-27,11,1,57,69,1700,565,1798,6.081731954240955,0.15752608695652176
2020-07-28,17,2,41,60,2485,810,951,6.342407123903148,0.20601333333333335
2020-07-29,26,5,29,60,12880,4734,1647,6.04204062362469,0.305885
2020-07-30,20,2,39,61,3106,1037,1153,6.413597722056925,0.2548409836065574
2020-07-31,30,2,43,75,14101,5325,1785,6.562925231747783,0.341032
2020-08-01,18,6,50,74,7927,2900,3058,6.313422642898897,0.16693648648648649
2020-08-02,18,7,55,80,6528,2376,1213,6.403386163605234,0.1576225
2020-08-03,18,3,57,78,2707,992,1632,6.0142273504388735,0.1833474358974359
2020-08-04,17,3,39,59,2706,1004,1099,6.2553100479071295,0.2501271186440678
2020-08-05,18,3,46,67,4167,1712,1595,6.323799937437706,0.2686716417910448
2020-08-06,10,3,41,54,2558,850,1020,6.325431663941605,0.14112037037037037
2020-08-07,17,3,36,56,2342,876,1163,6.300907352391827,0.2510339285714286
2020-08-08,10,2,44,56,1816,679,901,6.457621306982903,0.1913607142857143
2020-08-09,11,3,36,50,1745,686,1056,5.786198727016844,0.164378
2020-08-10,18,3,55,76,7337,2766,1143,6.265222785735871,0.21450263157894736
2020-08-11,17,4,68,89,2469,881,1272,6.1647303417036605,0.14831797752808987
2020-08-12,25,7,80,112,4149,1578,2206,6.1485522503852295,0.13967589285714285
2020-08-13,27,12,63,102,3322,1311,2529,5.991958995121613,0.16387450980392157
2020-08-14,27,3,61,91,2504,831,2246,6.183644923831748,0.2232912087912088
2020-08-15,19,2,36,57,2484,970,1082,6.148037150945343,0.2108964912280702
2020-08-16,18,6,55,79,2717,1018,1006,6.086325871228168,0.11826708860759494
2020-08-17,27,4,60,91,4638,1752,1531,6.035614864876554,0.22672417582417584
2020-08-18,14,4,55,73,2729,984,1139,6.142966159183131,0.13564657534246577
2020-08-19,24,1,49,74,2238,809,1180,6.2706662297102955,0.2531837837837838
2020-08-20,17,4,61,82,2659,950,1501,6.502956169566581,0.16429268292682928
2020-08-21,19,7,56,82,2709,1080,1128,6.270929991782751,0.1477890243902439
2020-08-22,15,2,29,46,1661,661,736,5.9200179273580575,0.18820217391304347
2020-08-23,8,2,36,46,1170,437,523,6.176253333600294,0.13848478260869565
2020-08-24,20,2,41,63,3460,1396,990,6.069013440740282,0.2845968253968254
2020-08-25,22,3,49,74,2266,833,1176,6.682646914658553,0.2547689189189189
2020-08-26,27,0,49,76,3563,1396,1244,6.338626859941252,0.2942026315789474
2020-08-27,20,8,48,76,4640,1795,1145,5.92531072243525,0.1794078947368421
2020-08-28,15,2,59,76,2127,769,810,6.355128788074634,0.1848736842105263
2020-08-29,15,2,28,45,2022,786,1022,5.727802490420628,0.2716911111111111
2020-08-30,25,2,45,72,4534,1737,1324,6.105240318026952,0.28056111111111115
2020-08-31,24,3,62,89,4936,1921,1946,6.047768409142892,0.2586887640449438
2020-09-01,27,4,89,120,8451,3179,2811,5.919868599345733,0.1915625
2020-09-02,35,5,82,122,6167,2006,1945,5.81027072886795,0.23579344262295082
2020-09-03,32,5,73,110,3349,1264,1590,6.10178810939149,0.20811545454545455
2020-09-04,25,6,44,75,4524,1782,991,6.195495811607964,0.20810133333333333
2020-09-05,25,3,56,84,3937,1634,1611,6.177933135216033,0.2088833333333333
2020-09-06,17,7,41,65,4994,2089,900,6.033901808132247,0.21980769230769232
2020-09-07,20,2,38,60,2394,891,744,5.980259901205332,0.29628000000000004
2020-09-08,13,4,50,67,2300,889,781,6.428419177207802,0.2151462686567164
2020-09-09,18,2,28,48,3586,1513,864,5.987657259871416,0.30020625
2020-09-10,13,4,51,68,4828,2067,944,6.269335185621314,0.1327529411764706
2020-09-11,19,9,43,71,4270,1765,748,6.051227110113991,0.19810000000000003
2020-09-12,18,4,47,69,2787,979,879,6.111730767102727,0.17431739130434784
2020-09-13,10,5,27,42,1069,309,558,6.639911545193,0.14210952380952382
2020-09-14,24,2,40,66,3543,1432,972,6.229887544543645,0.28672121212121215
2020-09-15,20,3,58,81,4367,1755,812,6.239053040848855,0.20305555555555557
2020-09-16,25,3,53,81,5389,2199,1189,5.992812427881234,0.25890123456790126
2020-09-17,18,7,67,92,3171,1210,1892,6.359824489532527,0.11113478260869565
2020-09-18,23,3,48,74,3636,1499,1839,6.425770260954446,0.25164594594594597
2020-09-19,15,1,52,68,3002,1176,950,6.34081527538483,0.18530441176470588
2020-09-20,15,2,40,57,2554,814,764,6.127336952208544,0.1799421052631579
2020-09-21,17,6,58,81,4483,1633,992,6.219572567345722,0.13563950617283949
2020-09-22,18,2,39,59,4527,1804,1031,5.933489985968187,0.23570677966101697
2020-09-23,20,6,46,72,3346,1260,1093,6.343211411826422,0.18574583333333333
2020-09-24,22,4,35,61,3306,1269,900,6.027537683437556,0.2813639344262295
2020-09-25,32,4,47,83,8551,3498,955,6.2256180812479425,0.3430325301204819
2020-09-26,21,5,50,76,4074,1537,627,6.364892067644359,0.1702171052631579
2020-09-27,11,4,39,54,2219,919,534,6.909749912873844,0.15024444444444446
2020-09-28,29,2,47,78,4507,1757,899,6.366256493589305,0.3040551282051282
2020-09-29,15,5,51,71,2469,919,855,6.185622697778947,0.18914084507042253
2020-09-30,13,6,60,79,3195,1311,757,6.036820479236889,0.18809493670886077
2020-10-01,14,1,36,51,1603,589,777,6.2535926978998235,0.22761176470588235
2020-10-02,20,4,43,67,3937,1518,720,6.081344134276896,0.2510402985074627
2020-10-03,20,8,56,84,4308,1676,673,6.062469867628101,0.14912023809523808
2020-10-04,14,3,26,43,2496,1000,579,5.807092061631476,0.23521162790697675
2020-10-05,19,2,40,61,3467,1115,579,6.297450675368735,0.31600491803278685
2020-10-06,23,4,38,65,2290,857,640,6.414828086579946,0.26592307692307693
2020-10-07,20,3,73,96,3494,1380,784,6.712729988241713,0.21048645833333335
2020-10-08,23,4,47,74,5718,2110,647,6.074015923476836,0.22951081081081084
2020-10-09,10,3,40,53,2366,924,665,6.113472202876241,0.1403490566037736
2020-10-10,13,1,37,51,2191,831,453,6.04136318418515,0.2645941176470588
2020-10-11,8,3,34,45,2042,807,965,6.077884056521022,0.1283111111111111
2020-10-12,14,4,53,71,2994,1034,716,6.152217525124461,0.13010845070422536
2020-10-13,19,6,41,66,3042,1024,589,6.151074769991551,0.22362878787878787
2020-10-14,24,2,47,73,4798,1942,627,6.030289850463303,0.3049383561643836
2020-10-15,14,1,46,61,3892,1673,640,6.335246448091076,0.2369032786885246
2020-10-16,20,2,38,60,2516,991,774,6.1577269140421045,0.26493333333333335
2020-10-17,20,1,29,50,2161,761,685,6.075993529527607,0.294758
2020-10-18,14,2,24,40,2259,890,604,5.886402946492764,0.2627625
2020-10-19,19,2,45,66,2623,793,638,6.152507954548865,0.24147575757575757
2020-10-20,12,2,43,57,3097,1234,938,6.358043683696562,0.16522456140350877
2020-10-21,14,0,63,77,2721,999,1635,5.96376012229509,0.19036233766233765
2020-10-22,16,3,53,72,3690,1432,1188,6.005435981296269,0.2158513888888889
2020-10-23,12,2,66,80,6040,2365,794,6.2195411983018865,0.18660375
2020-10-24,20,1,52,73,3054,1220,619,6.333524871813324,0.21770958904109589
2020-10-25,15,4,38,57,8635,3500,605,6.345218533255799,0.18563157894736843
2020-10-26,17,6,52,75,3318,1247,659,6.736485605043431,0.169152
2020-10-27,12,2,68,82,6285,2496,751,6.396044391592506,0.18120365853658538
2020-10-28,12,4,43,59,3338,1114,751,6.184633932861332,0.05055254237288136
2020-10-29,12,2,51,65,3502,1338,921,6.12854928048966,0.23205384615384617
2020-10-30,17,2,53,72,3579,1341,774,6.391100372053021,0.23200833333333332
2020-10-31,7,1,40,48,1296,448,377,6.1801058649338545,0.21116041666666666
2020-11-01,13,3,37,53,2056,853,715,5.969859989574586,0.18634716981132077
2020-11-02,20,6,61,87,3936,1479,833,5.991104870009355,0.18095977011494255
2020-11-03,18,3,61,82,3472,1315,702,6.051718698176831,0.14434634146341463
2020-11-04,18,3,48,69,3097,1182,1394,5.983322953724279,0.19502753623188404
2020-11-05,24,0,64,88,4771,1976,1462,6.170949247484999,0.2269465909090909
2020-11-06,30,2,60,92,4767,1917,1557,6.122601711764165,0.2662836956521739
2020-11-07,8,5,45,58,1975,670,749,6.178686641304578,0.10582931034482759
2020-11-08,11,4,44,59,1882,696,602,6.158911907371688,0.10220508474576272
2020-11-09,17,4,61,82,3292,1231,1090,6.111802139829725,0.16199878048780486
2020-11-10,30,5,60,95,3924,1485,1175,6.086684315395377,0.23826
2020-11-11,30,4,41,75,2878,1128,1083,6.077205899432314,0.309104
2020-11-12,20,1,63,84,4645,1786,1038,6.337984072669651,0.2020797619047619
2020-11-13,15,4,57,76,3638,1449,1049,5.947409267783626,0.1520907894736842
2020-11-14,16,2,41,59,3138,1183,660,6.2625026377764,0.21666271186440678
2020-11-15,24,6,42,72,4327,1465,742,6.087294909691473,0.24539027777777778
2020-11-16,24,3,61,88,2455,882,1003,5.999833185122998,0.2399159090909091
2020-11-17,24,3,62,89,4183,1514,2312,6.109026233173385,0.22827865168539327
2020-11-18,34,5,69,108,5003,1876,1226,6.145693646645576,0.27705555555555555
2020-11-19,35,2,43,80,3553,1357,1283,6.143991390342033,0.33856625
2020-11-20,25,6,72,103,3287,1220,2222,6.175649305121387,0.19544271844660197
2020-11-21,34,5,54,93,4686,1818,2131,6.1012570138993,0.26517096774193544
2020-11-22,28,7,65,100,4632,1668,1706,6.2713375634799435,0.209632
2020-11-23,42,2,94,138,8143,3377,3528,6.212627218802874,0.2552485507246377
2020-11-24,37,2,103,142,7366,2690,1978,6.008513044209794,0.2606112676056338
2020-11-25,31,7,78,116,6554,2365,1429,6.054730469306478,0.2004112068965517
2020-11-26,29,5,66,100,5436,2063,1470,6.120914432704374,0.244877
2020-11-27,22,2,51,75,2973,1073,848,6.099259153723255,0.22962666666666667
2020-11-28,25,1,59,85,2501,892,897,6.233995130549734,0.23435529411764708
2020-11-29,27,3,53,83,3627,1435,1217,6.100671703068021,0.2517566265060241
2020-11-30,29,7,65,101,4421,1705,1797,6.078009411209035,0.18963168316831683
2020-12-01,29,8,92,129,5368,1964,1936,6.1530503775733125,0.17148527131782945
2020-12-02,24,6,65,95,4968,1923,1407,6.079085519564435,0.19666315789473685
2020-12-03,18,4,77,99,3250,1244,1515,6.151759206147237,0.16154141414141412
2020-12-04,26,9,76,111,4758,1748,1317,6.417746665017675,0.16827747747747746
2020-12-05,24,3,57,84,3390,1322,1099,6.026116414699938,0.1831511904761905
2020-12-06,26,4,61,91,2814,1089,950,6.056280346912374,0.19077142857142856
2020-12-07,24,6,71,101,4207,1577,1174,6.213441347412745,0.1902851485148515
2020-12-08,24,3,71,98,3057,1055,1014,6.39313797842115,0.2312857142857143
2020-12-09,17,3,65,85,2148,767,1017,6.360073444899653,0.17461529411764706
2020-12-10,25,1,62,88,4527,1668,929,6.346775089047006,0.2551136363636364
2020-12-11,21,6,56,83,4873,1896,724,6.2931268847062185,0.1389144578313253
2020-12-12,32,1,55,88,5397,2020,849,6.292428195176398,0.3140852272727273
2020-12-13,18,1,50,69,3871,1542,884,6.3821557343506035,0.22857391304347824
2020-12-14,20,5,60,85,3759,1403,1020,6.321937673048516,0.1923270588235294
2020-12-15,22,5,56,83,3438,1340,1376,6.091156493678333,0.2509132530120482
2020-12-16,30,4,72,106,4881,1802,2055,5.98208051694448,0.2559320754716981
2020-12-17,35,8,72,115,4714,1943,2296,6.168594560029884,0.21044869565217392
2020-12-18,30,2,64,96,4886,1798,1392,5.802260889373806,0.2374802083333333
2020-12-19,35,5,61,101,5555,2170,1461,5.980460083788049,0.27066435643564357
2020-12-20,38,4,68,110,5908,2347,1582,5.875654455863948,0.29983909090909094
2020-12-21,34,8,71,113,6894,2446,1773,6.19752077886431,0.2215849557522124
2020-12-22,29,5,70,104,7524,2331,1249,6.133748762632062,0.175875
2020-12-23,29,4,76,109,5060,1964,1365,6.315577010131528,0.23854128440366973
2020-12-24,25,6,66,97,3017,1162,1262,6.329345711282154,0.14398350515463917
2020-12-25,13,2,49,64,2857,1103,1327,6.1291634422913,0.20477499999999998
2020-12-26,26,3,64,93,6232,2380,1745,5.947934204509952,0.24411935483870967
2020-12-27,33,8,78,119,6290,2362,2536,5.882610048235937,0.20466134453781515
2020-12-28,41,2,77,120,4775,1767,2036,5.918999574452709,0.29099416666666666
2020-12-29,41,7,67,115,6077,2432,2043,5.846493848406663,0.25919217391304344
2020-12-30,30,9,81,120,6247,2498,2063,5.865184768917003,0.20266333333333333
2020-12-31,38,8,78,124,6250,2530,1562,6.101734253388544,0.21102903225806452
2021-01-01,34,10,74,118,7035,2870,2030,6.14676150616309,0.18032033898305083
2021-01-02,41,11,76,128,8637,3492,2661,6.079901698671137,0.209821875
2021-01-03,76,14,171,261,10147,3990,6720,5.7982279429990395,0.2283800766283525
2021-01-04,67,13,176,256,14091,5890,4765,5.768076588200071,0.213582421875
2021-01-05,61,13,147,221,12404,4903,3867,6.00926797469843,0.20061674208144797
2021-01-06,80,14,160,254,14434,5742,4739,5.980287611840096,0.21356692913385827
2021-01-07,65,18,145,228,10486,4132,4448,5.857869337677084,0.1904359649122807
2021-01-08,75,9,159,243,10646,4322,3348,5.88469083879543,0.26447448559670783
2021-01-09,65,9,127,201,9627,3988,4100,5.7985478483432,0.2768084577114428
2021-01-10,76,10,165,251,12208,4953,4094,6.1146760581424076,0.22548565737051793
2021-01-11,70,12,144,226,9681,4031,4333,5.884651227963142,0.22498761061946904
2021-01-12,71,5,129,205,9189,3602,3188,5.996467830141088,0.2967
2021-01-13,51,7,118,176,9556,3792,2413,5.954515894223018,0.19259034090909088
2021-01-14,63,11,121,195,10943,4402,2935,6.110505656530215,0.25093692307692306
2021-01-15,67,6,146,219,12612,4849,3049,6.006720601144228,0.28357671232876713
2021-01-16,43,10,126,179,7035,2793,2818,5.870001338285732,0.20095977653631286
2021-01-17,65,7,100,172,9571,3817,2658,5.9445388546545015,0.2891970930232558
2021-01-18,69,13,113,195,12335,5006,3151,6.053415797457002,0.2613005128205128
2021-01-19,80,16,223,319,12708,4879,4756,6.0545405786796795,0.217135736677116
2021-01-20,76,13,183,272,12293,4911,3408,5.970462432329926,0.24817867647058822
2021-01-21,64,18,152,234,11312,4232,3782,6.126440933050328,0.19317307692307692
2021-01-22,63,12,134,209,15254,6442,3372,5.928636913531427,0.21891435406698562
2021-01-23,54,7,96,157,10047,4106,2302,6.024037710583302,0.272824203821656
2021-01-24,52,13,100,165,10784,4224,3721,5.858861023574329,0.22067757575757577
2021-01-25,68,11,166,245,12817,5000,2784,6.075942276565561,0.19703102040816325
2021-01-26,71,10,133,214,14368,5729,2710,5.93851870277713,0.2549126168224299
2021-01-27,62,8,188,258,10911,4231,3723,6.233946025167368,0.20291395348837207
2021-01-28,70,16,242,328,9872,3807,4169,6.022575942537348,0.15880701219512197
2021-01-29,122,25,428,575,21143,8250,4480,6.242086024138882,0.16295495652173914
2021-01-30,139,25,326,490,21900,8922,4430,5.908008480900375,0.21109
2021-01-31,102,22,298,422,15439,5947,2697,5.9782618347777765,0.19628981042654028
2021-02-01,98,19,283,400,15468,6131,2734,5.933884874786749,0.17882974999999998
2021-02-02,163,34,362,559,25299,10184,5731,6.003466262044701,0.2138216457960644
2021-02-03,153,20,407,580,25944,10401,6059,5.952728338601648,0.22876965517241377
2021-02-04,171,28,356,555,27378,11212,5673,5.77360631791783,0.2390981981981982
2021-02-05,152,21,425,598,22485,8859,5727,5.793810146313331,0.19872943143812707
2021-02-06,129,22,270,421,20747,8379,3567,5.783133346355378,0.23699667458432302
2021-02-07,124,28,299,451,19731,7950,4632,5.895754775376808,0.20317937915742793
2021-02-08,158,29,290,477,25388,10200,5859,5.976528753218422,0.24065765199161426
2021-02-09,147,26,362,535,24722,9936,6003,5.938284579215491,0.22367682242990655
2021-02-10,143,19,329,491,23812,9532,4842,5.885517992722912,0.24150366598778003
2021-02-11,145,24,278,447,21239,8207,4354,5.988136560474657,0.25332662192393735
2021-02-12,120,18,259,397,19466,7251,4401,6.03127469437934,0.23103979848866502
2021-02-13,136,11,235,382,20413,8299,3469,6.104874360743325,0.291330890052356
2021-02-14,123,22,220,365,19002,7607,4134,5.8521323595881585,0.26663287671232877
2021-02-15,125,28,253,406,25319,10567,4176,5.858206407962988,0.23271970443349754
2021-02-16,133,14,248,395,20747,8442,5263,5.7291354210666166,0.2748574683544304
2021-02-17,143,14,268,425,20575,8189,4772,5.812694876055675,0.28055576470588234
2021-02-18,150,26,352,528,24550,9844,5183,5.789659416589994,0.22300265151515153
2021-02-19,167,37,320,524,30455,12504,6901,5.960103560135307,0.22265286259541986
2021-02-20,132,18,357,507,22859,9328,5109,5.862094183060849,0.21571499013806708
2021-02-21,127,27,270,424,24545,9759,4440,5.950051598062616,0.23289811320754716
2021-02-22,161,35,342,538,28800,11681,5413,5.842452157650551,0.21799089219330856
2021-02-23,156,38,341,535,29114,12038,5542,5.7238092465903,0.19863869158878503
2021-02-24,140,29,260,429,24844,10086,5177,5.872495138147081,0.2480724941724942
2021-02-25,113,16,315,444,17219,6667,4046,5.93880623438319,0.21022274774774774
2021-02-26,121,30,304,455,22601,8825,5255,5.958359930716675,0.18819032967032967
2021-02-27,101,24,239,364,22218,9185,4527,6.005092672170598,0.1983813186813187
2021-02-28,96,27,325,448,20746,8293,5327,5.958555400753906,0.16879107142857142
2021-03-01,88,26,217,331,14368,5571,3798,6.058334441914088,0.1683764350453172
2021-03-02,98,14,258,370,15312,6040,3037,6.153447860171959,0.20608783783783782
2021-03-03,110,11,247,368,13930,5350,2987,6.026471259199471,0.22810869565217393
2021-03-04,99,17,237,353,17796,6969,3110,5.911827031743766,0.21181359773371106
2021-03-05,100,19,206,325,17952,7176,2776,5.932935013458214,0.23016615384615385
2021-03-06,98,23,253,374,17916,7104,3230,5.9274145553948605,0.20989064171122995
2021-03-07,90,24,225,339,16373,6600,3391,6.027290266738815,0.19660973451327435
2021-03-08,123,20,217,360,19501,7897,3492,5.836997154663564,0.27357194444444444
2021-03-09,118,24,242,384,17313,6930,3867,5.843441312761329,0.22210989583333332
2021-03-10,118,21,248,387,16237,6386,3032,5.924239513199634,0.22971653746770027
2021-03-11,102,16,206,324,18488,7288,3029,5.941424499257707,0.2550182098765432
2021-03-12,90,23,198,311,18608,7370,3671,5.983729314814966,0.21107363344051447
2021-03-13,101,17,238,356,14955,6038,4193,5.886384019963132,0.222013202247191
2021-03-14,111,20,243,374,18933,7825,3104,6.306104928690333,0.22968663101604278
2021-03-15,91,16,170,277,12834,4944,2849,5.7696437167331736,0.24409638989169674
2021-03-16,114,18,285,417,18086,6989,4833,5.9081892639461,0.20764964028776978
2021-03-17,111,17,241,369,18355,7225,2957,6.340862266844965,0.2403661246612466
2021-03-18,119,17,242,378,19554,7774,2733,5.912127695674504,0.24567380952380952
2021-03-19,90,21,202,313,16108,6505,2572,5.991827634776844,0.2113958466453674
2021-03-20,100,25,210,335,17471,6891,4064,5.892758751943475,0.2015137313432836
2021-03-21,101,16,210,327,19400,7928,3108,5.878887516499199,0.23318837920489296
2021-03-22,114,21,228,363,17111,6961,4305,5.9504772810200235,0.22166115702479336
2021-03-23,86,13,206,305,18445,7300,2671,5.805391905028088,0.2543380327868852
2021-03-24,100,19,208,327,18032,7110,3002,5.933638858604932,0.22762599388379207
2021-03-25,91,15,177,283,15490,6267,3200,5.899985148099069,0.2435862190812721
2021-03-26,93,11,188,292,15841,6403,2685,5.992459116820572,0.25559794520547946
2021-03-27,89,23,163,275,15547,6235,2229,5.941895427101093,0.21701672727272728
2021-03-28,83,23,165,271,17111,6941,2629,5.951057813273664,0.21523505535055348
2021-03-29,94,17,213,324,18518,7322,3200,6.038405576514631,0.23799413580246914
2021-03-30,85,8,165,258,19392,7817,3355,6.041142158473108,0.2708937984496124
2021-03-31,101,19,215,335,15836,6294,4391,5.878114749221527,0.22177850746268657
2021-04-01,116,24,246,386,18935,7625,3754,5.785985740076683,0.21639844559585492
2021-04-02,124,29,297,450,23301,9136,5244,5.793963136698886,0.20444933333333334
2021-04-03,104,18,206,328,20672,8406,3129,5.785976534914434,0.24168506097560977
2021-04-04,97,9,216,322,16363,6495,2925,5.81323588069985,0.25872732919254654
2021-04-05,104,12,209,325,16421,6805,3650,5.914982010253179,0.2671996923076923
2021-04-06,98,13,205,316,14418,5694,3512,6.182134369308988,0.24709367088607592
2021-04-07,118,22,254,394,19624,7866,3678,5.851946593974282,0.23358908629441624
2021-04-08,105,21,222,348,18820,7498,2765,5.993963319309054,0.21584281609195402
2021-04-09,115,15,209,339,18098,7181,2964,5.962049412192858,0.2723604719764012
2021-04-10,100,14,212,326,18294,7461,2928,5.884455521251407,0.22726196319018405
2021-04-11,92,13,189,294,15654,6174,3413,5.851045259032662,0.2503207482993197
2021-04-12,115,14,259,388,18603,7420,4594,5.940455796219467,0.2511672680412371
2021-04-13,119,25,275,419,20043,8005,4928,5.933205753753392,0.2045620525059666
2021-04-14,156,28,311,495,30062,12245,6104,5.9094654057158085,0.22906767676767675
2021-04-15,150,19,374,543,23201,9133,5804,5.865525439115637,0.20366906077348065
2021-04-16,123,30,262,415,22319,8941,4470,5.815281473497783,0.2132568674698795
2021-04-17,102,16,249,367,15216,5995,3455,5.829724005925129,0.20727111716621255
2021-04-18,111,26,308,445,15246,5886,4207,5.956069896831301,0.17814943820224718
2021-04-19,125,23,257,405,18930,7365,3812,5.783166401534892,0.2484916049382716
2021-04-20,135,27,319,481,22466,8985,4152,6.02438670072827,0.2137022869022869
2021-04-21,132,18,329,479,25320,10188,4409,6.061811229082731,0.22583883089770354
2021-04-22,155,31,338,524,24853,9724,6809,5.882678115672766,0.20554408396946566
2021-04-23,134,21,334,489,22710,8554,4466,5.957427137287195,0.20278364008179958
2021-04-24,116,16,254,386,22990,9257,3471,6.098544092374948,0.2242624352331606
2021-04-25,127,22,315,464,20343,7629,3955,5.932741861622215,0.2103782327586207
2021-04-26,135,26,322,483,26311,10414,5575,5.979127602347473,0.2148354037267081
2021-04-27,128,20,296,444,19027,7431,5153,5.961783811559802,0.22974887387387388
2021-04-28,136,29,347,512,24867,10034,5321,5.943703350265168,0.199807421875
2021-04-29,146,25,329,500,22688,9263,5481,5.841012307361332,0.229289
2021-04-30,121,18,297,436,21694,8809,4750,5.816906660225807,0.21518532110091745
2021-05-01,127,27,337,491,20394,8320,5678,5.84943179071279,0.20402301425661917
2021-05-02,131,26,286,443,20490,8314,6591,5.7945085927302165,0.23747562076749437
2021-05-03,208,36,671,915,30011,11760,10377,5.7394166994018905,0.17798568306010928
2021-05-04,197,50,444,691,28523,11699,7759,5.758359415812694,0.2004696092619392
2021-05-05,157,20,352,529,24270,9959,6806,5.947064828698463,0.2347022684310019
2021-05-06,142,28,353,523,25312,10442,6844,5.93519163058197,0.21364359464627153
2021-05-07,115,30,335,480,17819,7061,5541,5.882881887458947,0.19106291666666667
2021-05-08,115,35,425,575,19653,7899,7729,5.85495935394246,0.1381295652173913
2021-05-09,142,27,428,597,23426,9333,6757,5.8961519171297345,0.18422462311557788
2021-05-10,209,51,620,880,33923,13571,8934,5.838070311034343,0.17984590909090908
2021-05-11,155,42,413,610,32271,13160,6899,5.876315891597695,0.1977109836065574
2021-05-12,200,50,588,838,43357,17705,9922,5.902293347209554,0.18502649164677804
2021-05-13,189,61,500,750,40949,16940,10516,5.798526529862328,0.16312106666666668
2021-05-14,183,37,326,546,30832,12543,6465,5.872198262783188,0.23917106227106227
2021-05-15,143,34,265,442,21037,8336,4967,5.9528512239388425,0.20828981900452487
2021-05-16,123,31,396,550,25159,10222,6904,5.826674559119991,0.15907927272727274
2021-05-17,173,43,355,571,30643,12672,6353,5.802231645267867,0.20322626970227672
2021-05-18,176,24,274,474,27231,11590,5576,5.8958758071102215,0.27246434599156116
2021-05-19,209,100,596,905,37252,15197,10424,5.782220011392553,0.12399447513812155
2021-05-20,149,50,347,546,26502,10680,6346,5.952568051974294,0.1741084249084249
2021-05-21,136,51,299,486,27129,11142,6269,5.889142664617396,0.15206008230452675
2021-05-22,105,36,229,370,19163,7871,4464,5.897702711236735,0.17764972972972973
2021-05-23,127,33,342,502,23115,9823,6573,5.8370246344500325,0.1597137450199203
2021-05-24,120,34,293,447,17955,7203,4870,5.961493572469763,0.177462192393736
2021-05-25,116,33,277,426,20163,8067,4341,6.074030243011988,0.1812861502347418
2021-05-26,112,18,262,392,20237,7807,3696,5.924233015442394,0.22980433673469386
2021-05-27,120,14,193,327,19727,8186,3741,5.7491396723794645,0.285145871559633
2021-05-28,69,20,199,288,11849,4658,3046,5.837076215821595,0.1451798611111111
2021-05-29,67,23,222,312,12790,5121,3331,5.8109707320485375,0.1448698717948718
2021-05-30,75,21,181,277,18377,7652,3053,5.936157638936055,0.16934837545126355
2021-05-31,73,21,193,287,16906,6594,2413,5.973752192411914,0.1872411149825784
2021-06-01,91,18,198,307,16149,6501,3232,6.07012623945444,0.21816123778501628
2021-06-02,93,16,173,282,14234,5567,3116,6.369094830945437,0.24177695035460994
2021-06-03,98,6,237,341,16481,6492,3542,5.864101829704359,0.27163548387096775
2021-06-04,75,19,215,309,18080,7434,2914,5.927072571010207,0.16224854368932037
2021-06-05,78,24,165,267,13007,5316,2676,6.16172988352929,0.19605243445692885
2021-06-06,88,18,149,255,14768,5493,2966,6.188335124172331,0.24050274509803923
2021-06-07,82,26,195,303,15781,6196,2740,6.159050101468638,0.1698838283828383
2021-06-08,78,18,187,283,12333,4932,3179,5.877602374178065,0.18324416961130743
2021-06-09,80,17,213,310,16710,6537,3027,6.047915873574635,0.22377290322580648
2021-06-10,95,20,176,291,14024,5715,2555,6.037628752311821,0.23342680412371133
2021-06-11,61,18,172,251,12620,5092,2866,6.002817011451789,0.19143147410358566
2021-06-12,83,17,134,234,11990,4736,1743,5.889443263295869,0.24415213675213673
2021-06-13,66,14,145,225,13534,5606,1950,6.083996091004812,0.22744311111111112
2021-06-14,129,12,188,329,14111,5525,2438,6.041204279144603,0.3129674772036474
2021-06-15,79,14,152,245,14716,5954,2124,6.174785047836476,0.24928285714285714
2021-06-16,59,17,155,231,14210,5759,2331,6.169585880563846,0.16901515151515153
2021-06-17,73,9,169,251,13059,5077,2433,6.023790959338958,0.22861115537848606
2021-06-18,71,15,177,263,13125,5396,2457,6.349631637279828,0.18019467680608364
2021-06-19,58,20,157,235,12111,4964,2012,6.13201349802121,0.14658297872340426
2021-06-20,58,14,142,214,13126,3971,2130,5.824452896476985,0.20688037383177568
2021-06-21,88,24,191,303,17934,7027,3924,5.951436096439678,0.19931749174917493
2021-06-22,72,21,218,311,12823,5065,3606,5.978014066334561,0.1579540192926045
2021-06-23,58,15,170,243,12624,5146,2950,5.975691520554591,0.20304691358024693
2021-06-24,66,13,145,224,12834,5007,2062,6.040415153799164,0.2414669642857143
2021-06-25,71,12,155,238,11593,4515,2652,6.019595112470218,0.23005546218487394
2021-06-26,64,16,151,231,10524,3731,2866,6.020039032834751,0.21498441558441558
2021-06-27,60,24,124,208,12017,4877,2340,6.005500686549287,0.17327788461538463
2021-06-28,65,14,148,227,11878,4722,2845,5.876757802469188,0.23233348017621144
2021-06-29,70,12,172,254,12716,5099,2788,5.923433015176214,0.20966220472440944
2021-06-30,73,6,144,223,13320,5058,2205,6.2557227625089515,0.27301434977578476
2021-07-01,65,10,175,250,11051,3965,2175,6.022322211491662,0.2098124
2021-07-02,70,15,147,232,9093,3383,1956,6.360663442964983,0.2234310344827586
2021-07-03,51,16,132,199,10244,4106,1461,6.049809357265282,0.17484170854271358
2021-07-04,48,15,161,224,8559,3358,1836,5.924615088554746,0.14510625
2021-07-05,58,7,185,250,8655,3285,1607,6.18928508885583,0.2034216
2021-07-06,61,10,202,273,10125,3961,2212,6.314816534121457,0.1800813186813187
2021-07-07,54,11,210,275,10108,3732,2424,6.203789807497359,0.17607127272727274
2021-07-08,73,16,193,282,13765,5471,2240,6.133971978603395,0.19698936170212766
2021-07-09,49,10,195,254,11696,4603,2440,6.135996590895183,0.15383070866141732
2021-07-10,53,11,155,219,8553,3268,3326,6.160124577254438,0.16630273972602738
2021-07-11,35,10,112,157,7320,2909,1899,6.198867010064992,0.1744980891719745
2021-07-12,54,10,182,246,11299,4495,2529,6.12226989403431,0.17664349593495937
2021-07-13,62,11,198,271,9785,3656,2859,6.192383603371994,0.1613490774907749
2021-07-14,37,11,201,249,9637,3639,2331,6.144824285986064,0.13284497991967872
2021-07-15,51,11,176,238,8812,3511,2333,6.202301795292767,0.15544327731092436
2021-07-16,36,10,159,205,6550,2495,1641,6.307238646059604,0.1059209756097561
2021-07-17,41,15,150,206,9621,3871,1627,6.242714156547431,0.1298742718446602
2021-07-18,40,8,153,201,8694,3411,1789,6.10197341749647,0.17965124378109454
2021-07-19,49,15,184,248,10725,4249,2203,6.256519908741312,0.13381653225806453
2021-07-20,61,22,187,270,9760,3834,2952,6.248310091358479,0.14088444444444445
2021-07-21,57,11,162,230,10516,4083,2664,6.505871118727027,0.18516000000000002
2021-07-22,63,14,188,265,9152,3498,2771,6.271483293326434,0.17837169811320755
2021-07-23,47,9,154,210,9335,3718,2234,6.0758023230994285,0.18509809523809526
2021-07-24,34,12,113,159,7584,3058,1953,5.952823329462937,0.1622805031446541
2021-07-25,57,11,131,199,7757,3049,2045,6.092010610051543,0.21402462311557788
2021-07-26,74,18,197,289,11196,4559,3279,6.0329773442150865,0.1940370242214533
2021-07-27,51,18,195,264,9083,3492,2727,6.510754476842066,0.13870719696969697
2021-07-28,62,13,176,251,9357,3743,2394,6.154780082869769,0.21805657370517928
2021-07-29,60,19,171,250,8908,3539,2216,6.0896561368501585,0.1611496
2021-07-30,69,17,179,265,11169,4557,2938,6.156363652489021,0.18265547169811322
2021-07-31,73,11,179,263,9633,3673,3868,6.047752978494748,0.20689277566539924
2021-08-01,54,25,203,282,11112,4362,2871,6.021376035558801,0.1024741134751773
2021-08-02,59,10,210,279,9214,3465,3270,6.210121506812156,0.16937132616487457
2021-08-03,53,11,212,276,9919,3802,2113,6.360582263392456,0.13834347826086957
2021-08-04,66,19,239,324,10006,3952,3644,6.320739908126613,0.1491422839506173
2021-08-05,98,31,460,589,19428,7524,6234,6.073530813758122,0.10848522920203736
2021-08-06,83,24,286,393,13822,5387,4339,6.33588440737028,0.15934071246819337
2021-08-07,104,18,293,415,14087,5566,4981,6.181118810606456,0.18469180722891565
2021-08-08,85,22,209,316,12904,5240,3999,5.884031467517941,0.1847126582278481
2021-08-09,78,10,217,305,14569,5729,3558,6.077294684226678,0.20032590163934427
2021-08-10,70,24,239,333,12630,4892,3648,6.0452881432032655,0.1430081081081081
2021-08-11,81,26,244,351,14638,5992,3839,5.979771241883312,0.1588831908831909
2021-08-12,82,20,209,311,13867,5649,3991,5.945852968622905,0.2113459807073955
2021-08-13,88,15,186,289,11690,4561,4122,6.179091420158304,0.22536401384083046
2021-08-14,67,13,192,272,13361,5485,3111,6.2213134878872625,0.1997143382352941
2021-08-15,74,22,181,277,13656,5321,3114,6.06927962725875,0.18273971119133575
2021-08-16,89,12,201,302,13007,5299,4851,5.932021758264269,0.22432119205298015
2021-08-17,84,17,205,306,15081,5907,2516,6.201736059506544,0.21625032679738562
2021-08-18,67,14,178,259,10649,4100,2889,6.075622401066358,0.19033474903474903
2021-08-19,62,19,213,294,10662,4087,3659,6.465780806233559,0.13674319727891157
2021-08-20,89,11,185,285,16682,6625,3250,6.0519597186575504,0.24153298245614035
2021-08-21,76,14,145,235,16079,6339,3561,6.111127769151805,0.2541255319148936
2021-08-22,85,12,183,280,16492,6953,5075,5.974112955897522,0.2689560714285714
2021-08-23,78,10,211,299,18877,7847,4435,6.017682932619843,0.22763645484949832
2021-08-24,81,20,181,282,19744,8044,4038,6.070237616053102,0.2001421985815603
2021-08-25,84,26,171,281,14397,5902,4461,5.978039071687858,0.21095124555160144
2021-08-26,85,13,191,289,18518,7391,4790,6.049045200520724,0.24155709342560555
2021-08-27,82,10,185,277,16462,6699,3582,6.025905428174872,0.22907436823104693
2021-08-28,69,14,150,233,11964,4910,3415,6.209414052157555,0.2224450643776824
2021-08-29,75,14,156,245,15746,6528,2640,6.132893047029477,0.2585991836734694
2021-08-30,75,9,207,291,16004,6388,3679,5.992419534757496,0.19693539518900344
2021-08-31,88,12,172,272,15713,6584,3820,6.006960502708321,0.2367051470588235
2021-09-01,101,20,328,449,18746,7335,6141,5.935451333443785,0.17503006681514477
2021-09-02,81,18,260,359,16369,6395,4378,6.222039555982838,0.17682534818941503
2021-09-03,109,20,261,390,18556,7496,4780,5.896166294290208,0.2193197435897436
2021-09-04,72,17,150,239,13063,5327,3299,5.978053081263716,0.23088786610878662
2021-09-05,85,18,191,294,16533,6533,3966,5.972112499897876,0.22637925170068027
2021-09-06,76,17,217,310,16272,6321,3845,6.326107268122075,0.1969432258064516
2021-09-07,83,20,288,391,17008,6958,4339,5.913041280908493,0.17849053708439896
2021-09-08,103,24,239,366,19619,7888,4395,6.137299273371391,0.1865967213114754
2021-09-09,74,18,225,317,17487,7095,4652,6.290238872782973,0.16106498422712934
2021-09-10,59,14,182,255,13869,5724,5261,6.02386319973317,0.16088156862745098
2021-09-11,72,16,189,277,14206,5689,3768,6.128754948322188,0.18134729241877254
2021-09-12,73,16,180,269,19418,7911,5770,6.329342838481541,0.2098806691449814
2021-09-13,77,11,185,273,16396,6619,3526,6.435814650890709,0.23752637362637363
2021-09-14,66,14,196,276,18261,7455,4765,6.344897995368526,0.18380471014492752
2021-09-15,70,15,191,276,12538,4969,3319,6.232706363399607,0.17790869565217393
2021-09-16,52,12,195,259,12530,4824,2818,6.259095654184569,0.15162046332046333
2021-09-17,58,9,143,210,11465,4597,2919,6.312291098858085,0.22416095238095238
2021-09-18,62,6,138,206,9299,3583,2485,7.407576512731671,0.23258398058252427
2021-09-19,39,13,146,198,11359,4577,2642,6.424658497371952,0.15127272727272725
2021-09-20,79,14,207,300,17905,6929,3769,6.294962617625801,0.20321533333333336
2021-09-21,56,13,189,258,10664,4211,3289,6.290402218602338,0.16547093023255813
2021-09-22,55,26,182,263,12077,4914,3144,6.496272101567935,0.11624904942965779
2021-09-23,47,7,181,235,13358,5256,3089,6.506690759833388,0.16390893617021277
2021-09-24,45,15,188,248,11184,4397,2889,6.518009457468907,0.12331814516129032
2021-09-25,39,10,135,184,11070,4388,1966,6.284249617019525,0.18746467391304347
2021-09-26,44,8,115,167,9521,3998,2802,6.374488347666046,0.18249161676646705
2021-09-27,59,15,156,230,12209,4777,2713,6.364969220840245,0.1877613043478261
2021-09-28,45,13,187,245,11113,4356,3162,6.206035092089049,0.1144595918367347
2021-09-29,52,6,162,220,9431,3632,3033,6.426818768600829,0.19469909090909093
2021-09-30,68,10,159,237,15577,6114,2644,6.361324963652305,0.2331493670886076
2021-10-01,45,13,161,219,9980,4000,2907,6.353437982244333,0.14577123287671231
2021-10-02,56,7,110,173,10129,4240,2106,6.300417276100793,0.25670462427745666
2021-10-03,45,8,164,217,11546,4676,2193,6.369266969506771,0.14694838709677419
2021-10-04,56,8,175,239,10548,4247,2827,6.488020193029196,0.19172259414225942
2021-10-05,57,8,182,247,10738,4336,3549,6.325899829566201,0.17920364372469635
2021-10-06,60,12,174,246,10933,4462,2919,6.49183729962178,0.1770479674796748
2021-10-07,37,14,163,214,7857,3138,2806,6.599566778272126,0.12010046728971963
2021-10-08,59,8,189,256,13399,5577,2561,6.369654579649898,0.1877703125
2021-10-09,47,9,180,236,10528,4154,2218,6.405983254144074,0.15026440677966102
2021-10-10,39,10,144,193,9103,3818,2754,6.341599017861292,0.14129585492227978
2021-10-11,68,10,163,241,11372,4697,2804,6.559245736742359,0.20408381742738588
2021-10-12,57,10,198,265,12331,5129,3159,6.390278945650516,0.1777101886792453
2021-10-13,58,5,176,239,5714,2253,2847,6.3993280600368205,0.2004171548117155
2021-10-14,65,15,220,300,12042,4866,3382,6.29905748580608,0.146948
2021-10-15,72,16,207,295,13779,5545,3909,6.266478328673831,0.17326237288135593
2021-10-16,79,4,171,254,12331,4768,2946,6.505698052336403,0.23885669291338585
2021-10-17,56,13,157,226,9410,3725,2465,6.24403668961001,0.18053716814159293
2021-10-18,64,17,197,278,12793,5115,3443,6.445671773037721,0.1611751798561151
2021-10-19,70,12,189,271,11829,4755,3097,6.369012517780413,0.19424354243542435
2021-10-20,83,7,271,361,12177,4645,4664,6.387486186201922,0.19084487534626038
2021-10-21,79,10,266,355,12976,5268,4435,6.303256387359918,0.17645267605633805
2021-10-22,74,13,235,322,14633,5610,3348,6.353068969583138,0.16560962732919254
2021-10-23,56,3,180,239,9818,3802,2260,6.435380339803517,0.20143389121338912
2021-10-24,56,15,132,203,10638,4240,2247,6.272912505320795,0.1864487684729064
2021-10-25,79,11,176,266,16889,6888,3081,6.334305258486372,0.23537781954887219
2021-10-26,76,14,185,275,20686,8618,3196,6.32031180620847,0.21758472727272726
2021-10-27,46,19,217,282,15258,6090,3287,6.281214842775011,0.12195886524822695
2021-10-28,79,15,191,285,12644,5053,3980,6.2803982261356115,0.19377438596491228
2021-10-29,97,15,261,373,13908,5501,5312,6.3000371017202745,0.21514879356568364
2021-10-30,86,16,232,334,15813,6354,5102,6.237621994992392,0.2027185628742515
2021-10-31,66,14,186,266,11749,4585,4383,6.305374195109346,0.17401917293233082
2021-11-01,60,11,214,285,12335,4853,4318,6.280195561357149,0.16599052631578948
2021-11-02,102,14,308,424,14596,5765,6611,6.351024320969897,0.17620117924528303
2021-11-03,95,18,259,372,16137,6660,5554,6.46873049660896,0.18193172043010752
2021-11-04,74,21,205,300,15971,6517,4144,6.4145548386151585,0.17640066666666668
2021-11-05,69,8,193,270,15533,6117,3638,6.440714381015513,0.19621814814814817
2021-11-06,56,8,202,266,13832,5720,4213,6.455386515798831,0.16377067669172934
2021-11-07,75,23,191,289,14759,6146,5255,6.207694158745806,0.1788826989619377
2021-11-08,97,19,273,389,15339,6070,6020,6.35701248743327,0.18029768637532134
2021-11-09,90,17,287,394,18832,7567,7526,6.163686025330976,0.17921243654822336
2021-11-10,105,18,239,362,16217,6669,12733,6.438962743490525,0.20837762430939225
2021-11-11,102,28,202,332,16129,6413,4998,6.19043774217895,0.2115957831325301
2021-11-12,99,9,199,307,17619,6927,3597,6.1712319105602065,0.2507416938110749
2021-11-13,73,19,177,269,13221,5283,2847,6.1550102238098185,0.1814802973977695
2021-11-14,82,13,191,286,16672,6908,4273,6.217075140242961,0.23330034965034965
2021-11-15,92,18,208,318,16196,6440,4306,6.293814681161383,0.2115364779874214
2021-11-16,98,20,228,346,17255,6681,5704,6.015575745433927,0.21971878612716764
2021-11-17,76,15,223,314,21563,8843,4075,6.275112808306024,0.1908891719745223
2021-11-18,85,18,242,345,16767,6712,5206,6.339098444205241,0.18591565217391304
2021-11-19,79,12,226,317,16095,6765,4218,6.296553720223977,0.19311892744479495
2021-11-20,57,16,181,254,11265,4461,3645,6.606866150468224,0.15313307086614172
2021-11-21,80,12,188,280,19709,8151,4645,6.211564339015649,0.23980821428571428
2021-11-22,69,20,156,245,18032,7144,4146,6.190247033544683,0.1922995918367347
2021-11-23,66,17,172,255,11773,4748,3752,6.106743771960332,0.18878980392156863
2021-11-24,67,11,212,290,13797,5524,3174,6.3828825023311255,0.18161344827586207
2021-11-25,73,11,167,251,11174,4465,4680,6.21741415112946,0.235097609561753
2021-11-26,67,12,205,284,11904,4719,3527,6.180185904615003,0.16196549295774648
2021-11-27,64,21,184,269,13703,5500,3616,6.279596341030903,0.16136802973977696
2021-11-28,67,10,171,248,10817,4372,2719,6.155815445838317,0.2254516129032258
2021-11-29,77,13,171,261,11765,4748,4355,6.260069049864228,0.22142796934865902
2021-11-30,87,13,219,319,15072,6029,5696,6.259264804654572,0.23926050156739812
2021-12-01,57,12,226,295,10265,4092,5463,6.2208356220324825,0.14065864406779663
2021-12-02,89,19,206,314,14262,5737,3977,6.113760344079881,0.22385
2021-12-03,74,3,193,270,13192,5336,4466,6.508804916178005,0.23514925925925925
2021-12-04,71,24,221,316,12539,5099,5702,6.145086129285824,0.14690632911392407
2021-12-05,64,8,156,228,12614,5073,3578,6.190776756244196,0.2205469298245614
2021-12-06,74,16,182,272,14111,5592,5058,6.400731076360479,0.17955294117647058
2021-12-07,65,15,249,329,12601,4849,3621,6.680634480894068,0.13223951367781153
2021-12-08,64,15,205,284,10663,4049,4388,6.300166751315491,0.16817112676056337
2021-12-09,50,14,175,239,8466,3266,3520,6.375123320946416,0.15189456066945606
2021-12-10,55,9,222,286,14193,5447,3930,6.613370297746713,0.14352167832167834
2021-12-11,53,9,166,228,11968,4635,3705,6.308145215865903,0.19292192982456138
2021-12-12,54,12,162,228,10629,4136,3791,6.291860563953552,0.17498552631578948
2021-12-13,72,11,186,269,15240,6158,4851,6.120183309250582,0.20606914498141266
2021-12-14,55,15,186,256,10674,4178,3416,6.42750904516778,0.156149609375
2021-12-15,57,13,181,251,11063,4186,3980,6.283655445787122,0.16585657370517928
2021-12-16,73,13,149,235,12692,4908,4933,6.1680410470205995,0.22158808510638298
2021-12-17,49,12,132,193,9092,3604,6604,6.3551706463337325,0.1834740932642487
2021-12-18,46,11,142,199,8184,3221,3639,6.274672065936018,0.16753768844221104
2021-12-19,50,12,128,190,11060,4422,3004,6.624229534514995,0.1876121052631579
2021-12-20,52,11,146,209,10804,4356,4067,6.4937169962523225,0.218144019138756
2021-12-21,66,15,160,241,11329,4550,3261,6.1561552693483526,0.19406514522821577
2021-12-22,72,11,168,251,10865,4282,4252,6.381473510785043,0.2027207171314741
2021-12-23,55,9,143,207,9141,3570,3168,6.279455292574075,0.20450193236714975
2021-12-24,62,10,142,214,15310,6381,4176,6.487042898508299,0.23803551401869158
2021-12-25,48,5,124,177,6806,2668,3244,6.171385602881925,0.22068926553672316
2021-12-26,48,7,121,176,8966,3665,3403,6.489668514404396,0.21193409090909093
2021-12-27,56,6,159,221,11014,4267,3944,6.417640849075879,0.2033470588235294
2021-12-28,62,8,160,230,8661,3363,3302,6.243958482416839,0.21164478260869565
2021-12-29,69,8,161,238,11084,4493,3315,6.146180089777489,0.22290168067226893
2021-12-30,56,12,174,242,9613,3734,3492,6.143227350106586,0.1706082644628099
2021-12-31,49,11,106,166,7617,3126,2441,6.397249942386364,0.2119487951807229
2022-01-01,48,6,96,150,7882,3286,4182,6.3434390216740395,0.21026266666666668
2022-01-02,43,9,161,213,10367,4221,4042,6.353908504122007,0.11321314553990611
2022-01-03,65,16,182,263,13306,5376,3827,6.311036851933207,0.1694045627376426
2022-01-04,59,12,171,242,13281,4489,4250,6.323551395585334,0.17857809917355372
2022-01-05,72,25,195,292,10880,4329,4341,6.227107116472308,0.143675
2022-01-06,52,12,188,252,10698,4423,4879,6.1402646854466445,0.15106031746031745
2022-01-07,56,10,200,266,12793,5194,5031,6.210706548068949,0.1696281954887218
2022-01-08,49,16,177,242,10707,4370,4365,6.755028598633671,0.15452231404958677
2022-01-09,64,11,167,242,10710,4149,4155,6.278396276383962,0.19534338842975207
2022-01-10,54,13,176,243,10432,4087,4488,6.333639155971132,0.16766090534979422
2022-01-11,68,19,173,260,11318,4447,3261,6.436547553161897,0.17114576923076924
2022-01-12,47,8,161,216,10011,3805,3322,6.1364096143907725,0.18857824074074075
2022-01-13,73,6,162,241,13259,5222,3442,6.327425444392732,0.25526141078838177
2022-01-14,59,14,161,234,12047,4903,3470,6.331037639122912,0.17052948717948718
2022-01-15,51,7,108,166,10939,4152,2780,6.434408706103049,0.2510734939759036
2022-01-16,52,4,113,169,8525,3248,2767,6.1448460614209734,0.29132603550295855
2022-01-17,56,12,152,220,11672,4716,3558,6.274254307407168,0.1916281818181818
2022-01-18,57,13,144,214,9470,3922,3143,6.18255705936952,0.19366214953271027
2022-01-19,45,12,165,222,9841,3896,3403,6.289995911058213,0.16320675675675678
2022-01-20,80,13,132,225,14471,5765,6231,6.146201225875354,0.2564533333333333
2022-01-21,48,18,219,285,9604,3858,5419,6.299768921428373,0.10663754385964912
2022-01-22,62,19,193,274,9478,3675,6047,6.04074939673819,0.12143394160583941
2022-01-23,42,14,147,203,8358,3443,3296,6.0550487604566685,0.16419753694581282
2022-01-24,46,21,185,252,11190,4592,5297,6.179875818588164,0.11091825396825397
2022-01-25,44,9,151,204,10499,4308,3194,6.15977223893846,0.1832955882352941
2022-01-26,43,10,118,171,8959,3699,3871,6.301805631426476,0.17678070175438598
2022-01-27,49,10,134,193,9090,3883,3654,6.25013330145996,0.19591554404145078
2022-01-28,59,13,153,225,7765,2967,3644,6.306343639987236,0.22175911111111113
2022-01-29,50,7,112,169,10854,4245,3806,6.488795190106489,0.20522721893491125
2022-01-30,60,13,128,201,10981,4311,6469,6.299229303620012,0.2266243781094527
2022-01-31,51,7,132,190,11748,4589,3762,6.263152408803449,0.19015578947368422
2022-02-01,48,10,142,200,9116,3534,4272,6.093131697833544,0.19092849999999997
2022-02-02,55,4,166,225,8061,3143,3176,6.266028669486388,0.2061368888888889
2022-02-03,40,17,148,205,8272,3409,3385,6.610913772625138,0.12591804878048782
2022-02-04,40,8,138,186,8286,3095,3077,6.088219872608182,0.18488494623655913
2022-02-05,51,8,126,185,8156,3043,2773,6.15223024369393,0.21380972972972973
2022-02-06,36,14,146,196,8322,3308,3138,6.354497321721799,0.13286122448979593
2022-02-07,54,13,174,241,13004,5145,3695,6.4014181306330045,0.1629473029045643
2022-02-08,62,9,149,220,11792,4681,2821,6.143240732208423,0.20335772727272727
2022-02-09,57,6,160,223,10535,4218,3258,6.321604350604904,0.21575695067264572
2022-02-10,42,7,139,188,6504,2293,2479,6.285386985279104,0.19287180851063832
2022-02-11,55,6,141,202,8921,3555,2653,6.629977336403397,0.22691534653465348
2022-02-12,38,12,117,167,6123,2431,2327,6.1072314541059365,0.13818502994011977
2022-02-13,42,10,131,183,6604,2551,2195,6.160796518120052,0.1682786885245902
2022-02-14,46,8,141,195,6318,2380,1929,6.352803815655196,0.18383128205128205
2022-02-15,46,9,130,185,10677,4248,2239,6.697494769302475,0.2007756756756757
2022-02-16,45,11,144,200,9498,3797,1973,6.339436476825103,0.16585850000000002
2022-02-17,51,6,137,194,7546,2914,1891,7.768178261611496,0.18609536082474226
2022-02-18,65,6,147,218,7042,2714,1753,6.412544290048568,0.23713532110091745
2022-02-19,44,6,130,180,6417,2445,1286,6.895654968391051,0.187165
2022-02-20,35,8,119,162,7919,3175,1540,6.197242784929504,0.14284197530864198
2022-02-21,37,10,149,196,7479,2873,2232,6.334900140183358,0.12820561224489796
2022-02-22,53,15,149,217,12690,5383,2320,6.319174336582544,0.1907778801843318
2022-02-23,68,11,150,229,13168,5047,2377,6.138365345065673,0.21352620087336244
2022-02-24,36,24,163,223,8470,3414,3346,6.245899362906842,0.08291345291479821
2022-02-25,40,17,116,173,7314,2849,2023,6.2074331436905466,0.1371127167630058
2022-02-26,49,8,125,182,7762,2898,1684,6.185894801791559,0.21994450549450548
2022-02-27,41,13,123,177,9864,3976,1889,6.481144430354017,0.13168474576271186
2022-02-28,28,8,130,166,7819,3108,1732,6.7930997201497405,0.14971385542168675
2022-03-01,39,10,167,216,6806,2560,1803,6.244531299791828,0.14726990740740742
2022-03-02,43,13,130,186,8935,3577,1676,6.118994713864362,0.14107795698924733
2022-03-03,51,11,121,183,7073,2573,1788,6.220060063833897,0.22185464480874317
2022-03-04,46,11,133,190,5142,1934,2035,6.1808832314180675,0.20169631578947367
2022-03-05,37,9,83,129,4467,1701,3753,6.090249461985516,0.19227054263565893
2022-03-06,40,10,89,139,6083,2419,1494,6.482332984021758,0.16948561151079136
2022-03-07,42,8,105,155,6293,2338,1536,6.065263932312046,0.21908709677419355
2022-03-08,40,10,125,175,6824,2633,2045,5.995290383364234,0.18279657142857142
2022-03-09,40,7,101,148,6459,2509,1894,6.299918334887707,0.21309054054054052
2022-03-10,44,12,102,158,6996,2771,2312,6.063894731973592,0.20255253164556963
2022-03-11,35,8,115,158,5936,2271,1964,6.139987358807875,0.15852784810126583
2022-03-12,35,5,118,158,5131,1966,1676,6.497859612554607,0.2099474683544304
2022-03-13,22,8,84,114,4702,1872,1208,6.264976051663111,0.11345000000000001
2022-03-14,36,10,93,139,4652,1768,1651,6.241712518159078,0.17266330935251797
2022-03-15,25,12,127,164,4890,1748,1748,6.1030291491232544,0.10063658536585367
2022-03-16,45,4,126,175,6773,2533,2940,6.164912855666493,0.24455714285714286
2022-03-17,45,9,140,194,7163,2800,2367,6.60366392779177,0.20092164948453609
2022-03-18,36,5,104,145,5100,2014,2018,6.1396492090136885,0.20215655172413793
2022-03-19,40,9,100,149,6254,2355,1435,6.2143924967009285,0.19857046979865772
2022-03-20,38,5,106,149,9613,3879,2683,6.091994090225672,0.2522416107382551
2022-03-21,33,6,102,141,6163,2221,2940,6.0894598599512415,0.21457517730496453
2022-03-22,40,6,118,164,6008,2146,2748,5.9017995485095005,0.20052256097560975
2022-03-23,42,9,135,186,6010,2188,1932,6.1887050121684295,0.175844623655914
2022-03-24,40,5,107,152,6585,2422,2134,6.108346352495285,0.21609013157894738
2022-03-25,42,7,112,161,7746,3129,1627,6.225124995901087,0.22302422360248447
2022-03-26,46,12,96,154,7392,2928,1906,6.224747854658094,0.1940318181818182
2022-03-27,34,7,122,163,5330,2003,2207,5.9036628164998755,0.17334233128834356
2022-03-28,65,13,167,245,10276,3792,2841,5.996000139353598,0.2306326530612245
2022-03-29,44,12,109,165,9264,3678,3734,6.038811532401368,0.18627878787878788
2022-03-30,69,8,102,179,9227,3474,2126,6.0428970689858374,0.31032513966480446
2022-03-31,53,13,133,199,9609,3790,3201,6.53462402736975,0.17021306532663316
2022-04-01,57,13,124,194,9376,3792,2667,6.404880769140717,0.23213505154639175
2022-04-02,60,8,108,176,9923,3831,2916,6.368204421785225,0.2833778409090909
2022-04-03,31,5,98,134,4957,1763,1897,6.2462979278496835,0.21473582089552237
2022-04-04,39,10,114,163,6364,2377,2582,6.266332821159233,0.2180478527607362
2022-04-05,47,6,131,184,6604,2584,2511,5.887040120755671,0.20295489130434782
2022-04-06,47,6,124,177,10300,4087,2302,5.975352428004363,0.22136384180790963
2022-04-07,35,10,109,154,5043,1855,1902,6.426071142054379,0.16089025974025975
2022-04-08,38,5,134,177,9511,3784,3277,6.434775211329994,0.1897581920903955
2022-04-09,27,11,87,125,4834,1791,2096,5.984003399373346,0.1369936
2022-04-10,40,3,80,123,9642,3814,2038,6.0424013157097525,0.2733211382113821
2022-04-11,36,6,97,139,7381,3019,2788,6.492081204134735,0.20973453237410072
2022-04-12,37,6,107,150,6297,2374,3065,6.185270748998023,0.21659933333333334
2022-04-13,47,16,101,164,9428,3565,3639,6.026231876070764,0.18138658536585364
2022-04-14,40,15,117,172,7843,3138,3270,6.053304889752642,0.1579627906976744
2022-04-15,35,11,103,149,5533,2059,2802,6.147839335206048,0.14793422818791946
2022-04-16,37,4,123,164,6642,2470,2593,6.0489525995740685,0.19481158536585363
2022-04-17,31,8,111,150,4983,1912,3170,6.542274065928393,0.15997
2022-04-18,52,12,103,167,6941,2683,3116,6.003336591533434,0.20932634730538924
2022-04-19,50,7,136,193,9239,3776,4063,6.218935890328475,0.15980051813471502
2022-04-20,55,9,110,174,7916,3036,3083,6.152301140856127,0.28518045977011497
2022-04-21,82,8,113,203,9331,3603,2944,6.666881620832665,0.2637177339901478
2022-04-22,90,9,113,212,8117,3249,2138,7.469138892773773,0.288197641509434
2022-04-23,45,5,88,138,5282,1997,1358,7.330947590265858,0.2727289855072464
2022-04-24,44,8,72,124,7466,3014,1300,6.411666568424621,0.2267983870967742
2022-04-25,43,6,98,147,7675,2983,2316,6.234464642189756,0.24774217687074832
2022-04-26,46,7,85,138,6308,2450,2005,6.2305728742194235,0.25744057971014495
2022-04-27,62,5,95,162,8480,3292,1754,6.829491435408497,0.3079679012345679
2022-04-28,49,9,121,179,11028,4584,2883,6.292530960772738,0.2263027932960894
2022-04-29,45,9,105,159,7417,2979,2289,6.096201938005959,0.23443522012578616
2022-04-30,37,8,77,122,6100,2432,2086,5.875275131191811,0.23602704918032788
2022-05-01,39,12,94,145,5713,2113,1967,5.917639372121124,0.17199379310344828
2022-05-02,46,3,82,131,6132,2440,1739,6.029129052703915,0.2684549618320611
2022-05-03,40,8,82,130,9116,3580,2582,6.639996535077849,0.22862153846153846
2022-05-04,46,7,108,161,7658,2876,2103,6.4719230214048915,0.23243664596273292
2022-05-05,41,2,79,122,4982,1981,1655,6.279980258057779,0.291738524590164
2022-05-06,41,9,116,166,8991,3589,2278,6.211617814374619,0.18111204819277107
2022-05-07,30,11,76,117,4641,1842,1785,5.913755901573477,0.16523504273504272
2022-05-08,45,6,79,130,8278,3399,2346,6.212843301065782,0.23769538461538461
2022-05-09,36,16,117,169,7288,2789,3852,5.973689425128409,0.16767455621301774
2022-05-10,45,9,131,185,7234,2754,3049,5.980345492948064,0.21298216216216215
2022-05-11,45,23,134,202,9625,3848,4704,6.034648200599273,0.1123940594059406
2022-05-12,36,25,167,228,7494,2910,4617,6.099219421756692,0.07835438596491227
2022-05-13,59,14,83,156,5489,2104,2826,6.1376246004804065,0.23795833333333333
2022-05-14,44,14,97,155,9948,3677,2423,6.314894502092929,0.2688883870967742
2022-05-15,43,13,115,171,7509,2830,2420,5.952101879340893,0.22761111111111113
2022-05-16,61,9,102,172,7945,3095,2224,6.217909569342961,0.2891226744186047
2022-05-17,53,12,129,194,8716,3228,2157,6.164148591880408,0.27484381443298966
2022-05-18,45,7,159,211,9602,3789,2490,6.17130670705685,0.1608521327014218
2022-05-19,48,6,102,156,8669,3494,2157,7.16931416509027,0.26253269230769233
2022-05-20,31,6,87,124,9111,3270,2047,6.177421531249861,0.2279217741935484
2022-05-21,29,9,90,128,4636,1741,1640,6.110330455089939,0.1841640625
2022-05-22,33,9,91,133,6940,2700,2090,6.122797029942256,0.19732781954887216
2022-05-23,38,10,80,128,9088,3812,2436,6.508083033134008,0.2386828125
2022-05-24,47,5,84,136,7554,3048,2326,6.01816958319691,0.2835933823529412
2022-05-25,34,8,75,117,5430,2132,1721,6.202553382446137,0.21481709401709403
2022-05-26,43,10,68,121,7382,2982,2717,6.037207268392609,0.24762561983471076
2022-05-27,37,13,60,110,6046,2426,2369,6.0357932796691784,0.20855454545454544
2022-05-28,25,11,56,92,5740,2331,1822,5.980432001562301,0.1560913043478261
2022-05-29,24,6,53,83,5029,1994,1235,6.111502953395953,0.23666626506024097
2022-05-30,32,6,61,99,5013,2029,844,6.154654076341276,0.25890606060606064
2022-05-31,40,8,62,110,7621,3042,2117,5.949277139215412,0.3073809090909091
2022-06-01,18,10,37,65,6824,2827,945,6.379062850019082,0.1548523076923077
2022-06-02,29,8,67,104,6365,2397,1653,6.4304883711971295,0.22088653846153847
2022-06-03,36,7,63,106,6712,2692,1913,6.0871137969769356,0.2933952830188679
2022-06-04,34,6,71,111,5407,2145,1451,6.912260672200751,0.285190990990991
2022-06-05,17,5,88,110,4296,1672,1439,6.619380555292364,0.21984
2022-06-06,33,7,86,126,5860,2184,2071,6.025380661220981,0.23103492063492062
2022-06-07,44,7,80,131,6724,2456,2033,6.43103777766914,0.24161068702290076
2022-06-08,21,4,77,102,4056,1567,1973,6.258331965516159,0.1805166666666667
2022-06-09,27,4,64,95,4913,1971,1719,6.2126119314712485,0.25198631578947367
2022-06-10,26,8,51,85,7807,3238,2465,6.069010634004635,0.18245176470588234
2022-06-11,23,14,84,121,4807,1900,3647,6.0483902897609925,0.0926
2022-06-12,29,5,56,90,6412,2606,3423,5.788311884358389,0.2595188888888889
2022-06-13,46,22,121,189,11670,4997,6385,5.934981350749887,0.14802645502645503
2022-06-14,28,8,97,133,4752,1748,3282,5.855719003700938,0.15909774436090227
2022-06-15,33,13,88,134,6308,2582,3640,5.962588694909628,0.167689552238806
2022-06-16,25,6,87,118,4849,1931,3029,6.041792235076862,0.17368474576271184
2022-06-17,50,7,101,158,10400,4121,2838,6.468085794841685,0.2804759493670886
2022-06-18,34,10,71,115,4579,1810,4433,5.7369203564492155,0.2003304347826087
2022-06-19,30,8,83,121,7111,2907,2649,6.3045678853903535,0.16485289256198346
2022-06-20,47,3,87,137,5545,2236,2661,6.085287375667166,0.2610890510948905
2022-06-21,28,8,72,108,5539,2233,2095,6.1410083534225475,0.2441296296296296
2022-06-22,31,9,67,107,6824,2935,2483,6.831630525870034,0.205714953271028
2022-06-23,28,7,71,106,4777,1915,2092,6.3800438790172604,0.22355377358490566
2022-06-24,36,10,69,115,6017,2426,2004,6.19184698317227,0.2389817391304348
2022-06-25,19,5,55,79,3035,1210,1620,6.04003661677425,0.1453987341772152
2022-06-26,18,9,31,58,3646,1451,1719,6.164195524925714,0.15696206896551723
2022-06-27,31,10,45,86,6017,2332,1961,6.154311593705956,0.2327279069767442
2022-06-28,28,3,78,109,5857,2378,1917,6.443804376095301,0.21040825688073395
2022-06-29,28,6,44,78,13202,5375,1813,6.1013585259042245,0.2277923076923077
2022-06-30,24,8,52,84,4554,1784,1602,6.218819918332452,0.17638333333333334
2022-07-01,22,12,74,108,7344,2922,1982,6.226076981484251,0.10796296296296297
2022-07-02,15,7,54,76,2448,858,1223,6.201766958617104,0.10964342105263158
2022-07-03,20,3,40,63,3518,1353,1098,6.550963214957576,0.21666507936507937
2022-07-04,17,3,50,70,3859,1501,1130,7.168833185248132,0.1708257142857143
2022-07-05,28,4,55,87,3802,1506,1727,6.229714305259381,0.21063448275862068
2022-07-06,21,11,57,89,4780,1859,1835,6.29167842851344,0.13692921348314607
2022-07-07,26,5,52,83,4035,1619,1499,6.084804521000721,0.2661566265060241
2022-07-08,25,2,59,86,5585,2372,1690,6.224353968444535,0.24813953488372092
2022-07-09,15,2,27,44,4045,1716,1260,5.659068270538634,0.31734772727272725
2022-07-10,23,4,58,85,3276,1287,1762,6.190012506684256,0.2024694117647059
2022-07-11,20,8,58,86,3908,1499,2064,6.179422491015898,0.1416
2022-07-12,27,8,76,111,4527,1698,1480,6.4774341545202905,0.15384594594594594
2022-07-13,26,11,71,108,6781,2567,1639,6.079259585554932,0.1440712962962963
2022-07-14,35,2,71,108,6013,2334,1906,6.356810100812464,0.2856537037037037
2022-07-15,21,3,52,76,3451,1268,2144,5.916278881431128,0.2037013157894737
2022-07-16,28,6,63,97,4753,1855,1814,6.067839212537809,0.19369072164948453
2022-07-17,16,3,54,73,3731,1345,1397,5.902875107921318,0.19187671232876713
2022-07-18,36,6,64,106,5763,2331,2927,6.371762152755092,0.2895990566037736
2022-07-19,35,8,66,109,5273,2073,2478,6.0408565744161296,0.24325963302752293
2022-07-20,31,4,70,105,4971,2041,2358,6.125235168454458,0.24425904761904763
2022-07-21,34,6,62,102,6056,2388,1987,6.102833080562689,0.21601176470588235
2022-07-22,27,6,70,103,5153,1993,2001,5.995664833896393,0.16444757281553396
2022-07-23,19,7,48,74,4390,1708,1572,6.229035421190807,0.1513189189189189
2022-07-24,20,5,35,60,3626,1465,1672,6.328756887497147,0.22060333333333335
2022-07-25,29,4,46,79,5713,2305,1996,5.960909892071713,0.2853088607594937
2022-07-26,20,9,57,86,3654,1354,2167,6.389414136205678,0.197503488372093
2022-07-27,25,6,42,73,3687,1419,1825,5.972346515085405,0.21882602739726026
2022-07-28,33,5,78,116,5184,2050,2577,6.516561022843621,0.22075258620689658
2022-07-29,29,5,41,75,4451,1856,1867,6.417679486128618,0.26499333333333336
2022-07-30,18,4,50,72,2967,1232,1900,6.051243434582676,0.22707083333333333
2022-07-31,25,8,30,63,4128,1655,1967,6.911110572486303,0.2656714285714286
2022-08-01,28,9,64,101,5101,2003,1595,6.281234001622967,0.20948118811881186
2022-08-02,43,4,55,102,7071,2989,1895,6.495581504756566,0.3470029411764706
2022-08-03,34,7,66,107,3273,1186,2314,6.272666903470335,0.20085046728971961
2022-08-04,31,6,61,98,4165,1664,1611,6.274392865219583,0.22340816326530613
2022-08-05,27,4,86,117,5170,2040,1590,6.237324266652284,0.157117094017094
2022-08-06,28,7,76,111,5606,2075,2736,6.221610878747464,0.2112063063063063
2022-08-07,32,3,58,93,5299,2200,2014,6.129278710993948,0.25698279569892474
2022-08-08,25,5,67,97,3936,1506,2632,6.190045598908628,0.21665567010309278
2022-08-09,31,5,89,125,5233,2099,2204,6.26019174632022,0.22574719999999998
2022-08-10,34,3,87,124,6498,2424,2136,6.305577661409681,0.2319467741935484
2022-08-11,35,7,92,134,7741,3242,2716,6.109935182355234,0.18591417910447763
2022-08-12,35,8,74,117,6662,2715,2473,6.461531916453689,0.21216153846153846
2022-08-13,42,10,71,123,5658,2196,2395,5.849784262824397,0.21790243902439024
2022-08-14,16,9,67,92,3737,1446,1740,6.588422272370237,0.09346847826086957
2022-08-15,21,2,62,85,3756,1441,1611,6.167543715027351,0.19703529411764706
2022-08-16,37,5,74,116,6395,2622,2166,6.152044928338743,0.24657241379310343
2022-08-17,34,6,89,129,5631,2187,2150,6.355446476857253,0.21417596899224806
2022-08-18,33,5,80,118,6729,2733,1825,6.136486246009784,0.2265177966101695
2022-08-19,20,10,61,91,6762,2755,1820,6.365057474516589,0.1382087912087912
2022-08-20,22,7,55,84,4477,1885,1643,6.560083193493085,0.18450833333333333
2022-08-21,19,7,52,78,5268,2257,1377,6.22606554559087,0.16465641025641026
2022-08-22,19,8,60,87,4259,1564,1487,6.308616647018189,0.11901954022988505
2022-08-23,29,3,67,99,7927,3239,1722,5.989253873433792,0.23954747474747473
2022-08-24,16,5,69,90,4513,1700,1283,6.151761506936719,0.17342666666666667
2022-08-25,45,6,85,136,8341,3305,2639,6.157092163737415,0.2767558823529412
2022-08-26,37,5,103,145,5799,2393,2019,6.292534195385846,0.22844551724137932
2022-08-27,24,4,62,90,3439,1339,1505,5.977473481594194,0.24321777777777778
2022-08-28,26,5,62,93,4119,1693,1221,5.969294544110374,0.2057301075268817
2022-08-29,31,3,68,102,6221,2419,1238,6.4269639889541486,0.2592333333333333
2022-08-30,41,4,98,143,9494,3862,2112,6.243504248286242,0.26242727272727273
2022-08-31,26,9,64,99,4476,1769,2008,6.269317956265104,0.17663939393939396
2022-09-01,16,4,77,97,3896,1504,1484,6.378555870511898,0.10669896907216495
2022-09-02,23,1,59,83,5161,2033,1581,6.986053397607952,0.2340132530120482
2022-09-03,18,5,57,80,2958,1173,1144,6.251265719560504,0.20141125
2022-09-04,15,1,52,68,2172,786,1012,5.9346753023619305,0.1270676470588235
2022-09-05,27,4,69,100,5079,2090,1954,6.052280583641492,0.21511
2022-09-06,32,2,77,111,5266,2143,2476,6.3659836752157215,0.24211261261261263
2022-09-07,27,10,82,119,6193,2437,2201,6.165155433764177,0.17495546218487396
2022-09-08,16,8,49,73,4333,1682,1767,7.630840950527326,0.125886301369863
2022-09-09,33,9,65,107,5441,2102,1522,6.03287038951014,0.21845327102803738
2022-09-10,28,2,64,94,3951,1566,1817,5.887829453122717,0.2610914893617021
2022-09-11,21,5,71,97,3351,1156,1577,6.196994350458763,0.14287628865979382
2022-09-12,34,6,65,105,4546,1723,2581,6.574410660361724,0.21896761904761908
2022-09-13,27,6,89,122,4768,1802,2124,6.089807319882271,0.18933360655737705
2022-09-14,40,11,98,149,6729,2571,6345,6.125560179995709,0.18409932885906038
2022-09-15,86,22,232,340,13203,5113,8690,5.924967426217692,0.17794441176470588
2022-09-16,46,14,129,189,7887,3187,4094,6.316442517042428,0.19866772486772488
2022-09-17,36,12,99,147,5811,2281,2619,5.991018794293764,0.22531904761904764
2022-09-18,26,4,87,117,4322,1796,3326,5.809729140774594,0.2511324786324786
2022-09-19,29,9,78,116,6626,2762,2299,6.320605882114285,0.19730689655172412
2022-09-20,32,6,59,97,7785,3172,2179,6.946100870235092,0.24807835051546392
2022-09-21,30,4,58,92,5488,2152,2263,6.047076544830109,0.22068043478260868
2022-09-22,20,6,57,83,4168,1751,2290,6.26274901734511,0.14243855421686746
2022-09-23,18,2,48,68,3974,1494,1809,6.0361733649957445,0.1835235294117647
2022-09-24,16,2,41,59,3234,1375,1147,6.288345124220722,0.20487457627118644
2022-09-25,45,10,41,96,4147,1661,1684,5.968863832227364,0.2572041666666666
2022-09-26,14,4,48,66,4891,2062,1813,6.21152046722151,0.13915606060606062
2022-09-27,14,3,50,67,1957,734,1423,7.320558418886187,0.15334776119402985
2022-09-28,20,1,35,56,2975,1182,1279,6.6495169927628455,0.3315482142857143
2022-09-29,17,3,38,58,2949,1072,1619,6.711777766451469,0.2209793103448276
2022-09-30,15,3,26,44,1540,624,987,6.266782145945876,0.2757136363636363
2022-10-01,15,3,50,68,3271,1137,1197,6.2042474976929025,0.1849279411764706
2022-10-02,11,2,28,41,1848,729,828,7.0344299610802885,0.19389756097560978
2022-10-03,14,2,46,62,2039,737,1115,6.3221615982604495,0.23277580645161292
2022-10-04,21,4,32,57,3255,1252,1343,6.108836654596524,0.3069228070175439
2022-10-05,25,5,46,76,3321,1260,1324,6.437743002093327,0.24989736842105265
2022-10-06,20,0,36,56,3309,1239,1417,7.23479361544348,0.3002410714285714
2022-10-07,9,5,19,33,2169,858,945,5.965216050007787,0.15364848484848487
2022-10-08,12,3,27,42,2571,989,723,6.580838997456872,0.20445952380952384
2022-10-09,13,1,28,42,1444,569,614,6.165198936719755,0.19017142857142857
2022-10-10,14,0,38,52,2339,932,773,6.430703905585869,0.2664096153846154
2022-10-11,13,0,42,55,3087,1126,864,6.288856482441593,0.23051818181818182
2022-10-12,13,3,44,60,4231,1616,985,6.378907768722809,0.26369666666666663
2022-10-13,15,2,31,48,2367,914,1173,6.3393834284721295,0.23837708333333332
2022-10-14,16,2,28,46,4738,1820,1067,6.300207854614393,0.27599565217391303
2022-10-15,11,3,30,44,1529,603,725,6.414473681466339,0.15785681818181818
2022-10-16,8,2,33,43,2591,1090,797,6.431495344479239,0.16283488372093025
2022-10-17,16,3,33,52,4501,1774,939,6.471088875376859,0.23912692307692307
2022-10-18,15,1,49,65,3251,1358,739,5.953602057019276,0.19158
2022-10-19,18,3,31,52,3122,1215,948,6.161939335726983,0.31127692307692306
2022-10-20,16,3,37,56,6814,2689,1038,6.117241702136562,0.24477321428571427
2022-10-21,6,1,28,35,2632,1034,716,6.253155656226851,0.21678285714285717
2022-10-22,10,3,39,52,3037,1062,857,6.173357250909081,0.14309807692307694
2022-10-23,9,0,22,31,1715,638,666,6.140458995144833,0.2711193548387097
2022-10-24,13,3,46,62,1537,524,971,6.14851428740558,0.16831129032258063
2022-10-25,13,1,41,55,2925,1171,1293,6.476983089175866,0.2141909090909091
2022-10-26,9,3,56,68,2051,781,1477,6.217960041052218,0.16298529411764706
2022-10-27,17,2,57,76,3006,1186,743,6.2361630754646145,0.20587631578947369
2022-10-28,15,3,44,62,2613,1007,753,6.3502805882353925,0.24618225806451616
2022-10-29,13,5,39,57,4268,1670,1242,6.340453325431287,0.16606140350877194
2022-10-30,11,2,39,52,2608,1033,621,6.768972891393049,0.14854807692307692
2022-10-31,24,3,57,84,4311,1646,819,6.591568333518846,0.22791190476190476
2022-11-01,13,3,38,54,3007,1173,964,5.876854200091259,0.21451851851851853
2022-11-02,20,2,49,71,3179,1227,1009,5.974993837679877,0.27985352112676054
2022-11-03,24,4,45,73,4871,1946,1101,6.29803899855339,0.21944657534246576
2022-11-04,15,0,29,44,2034,820,1153,6.029923401422983,0.29074772727272724
2022-11-05,8,0,36,44,1479,483,678,6.921003950556943,0.23079545454545453
2022-11-06,8,2,34,44,1757,605,823,6.202860524342009,0.19953863636363636
2022-11-07,20,6,42,68,5026,2058,1191,6.2774006542339755,0.2985029411764706
2022-11-08,14,1,48,63,2513,871,2469,6.375010496834472,0.2088873015873016
2022-11-09,22,9,60,91,3329,1210,2711,6.113810057724553,0.12269670329670329
2022-11-10,19,2,55,76,2685,1014,2708,6.0756310145574055,0.1892263157894737
2022-11-11,22,7,53,82,3382,1236,2393,6.791579252510189,0.21279756097560976
2022-11-12,25,9,56,90,11057,4968,1873,6.282650393910267,0.19617333333333334
2022-11-13,14,5,48,67,2424,911,1414,6.403904017175064,0.1894820895522388
2022-11-14,22,9,42,73,4352,1783,2013,6.329149123018102,0.1560068493150685
2022-11-15,21,4,47,72,3689,1478,1579,6.2366651822484975,0.21524305555555556
2022-11-16,20,5,47,72,3307,1262,1675,5.959653492397077,0.17920694444444446
2022-11-17,21,8,74,103,3137,1046,1679,6.221572991873513,0.18158834951456312
2022-11-18,33,5,54,92,4022,1487,1786,6.237457360078956,0.26123804347826085
2022-11-19,18,2,55,75,2621,1039,1244,6.256026925568854,0.17025733333333332
2022-11-20,9,3,31,43,2269,933,1068,6.222529447846489,0.0977860465116279
2022-11-21,18,4,50,72,3321,1265,1740,6.475335861268471,0.18056527777777778
2022-11-22,15,5,47,67,1805,642,1183,6.183558084428684,0.20544626865671642
2022-11-23,30,4,62,96,5555,2046,1343,6.336137372523624,0.2944760416666667
2022-11-24,15,5,60,80,2652,977,1032,6.543182741631104,0.17654375
2022-11-25,12,1,41,54,1813,677,989,6.316467342794846,0.17052777777777775
2022-11-26,13,2,37,52,1424,475,783,6.980553764243772,0.20712115384615387
2022-11-27,24,0,39,63,1727,541,946,6.669584846179474,0.36553492063492066
2022-11-28,20,3,53,76,3355,1244,1087,6.5668941656214,0.26926052631578945
2022-11-29,9,0,52,61,1366,464,764,6.640539935682808,0.2649655737704918
2022-11-30,14,4,47,65,4163,1508,1070,6.319441284391552,0.25151384615384614
2022-12-01,19,3,33,55,4069,1500,1002,6.186450330622144,0.3143145454545455
2022-12-02,12,3,30,45,1353,473,856,6.244121513602995,0.18966666666666668
2022-12-03,23,0,27,50,3723,1425,488,6.75725538359421,0.39984400000000003
2022-12-04,11,2,21,34,1590,618,1051,6.440742190898754,0.17979411764705883
2022-12-05,11,1,53,65,3270,1244,699,6.715077100138791,0.21345076923076922
2022-12-06,18,1,72,91,4568,1813,767,6.526812489609923,0.19683296703296702
2022-12-07,12,4,72,88,2977,1119,1157,6.335062605368311,0.1116625
2022-12-08,22,4,62,88,2910,1046,1051,6.222781570686163,0.21558750000000002
2022-12-09,12,4,57,73,6487,2465,1010,6.374823351078232,0.16324520547945207
2022-12-10,24,1,35,60,1530,556,802,6.560977139620757,0.35893833333333336
2022-12-11,430,1,148,579,10543,2074,2485,5.710516611445072,0.5190288428324698
2022-12-12,162,5,144,311,6845,1909,1059,6.135183551194607,0.32951736334405146
2022-12-13,19,4,49,72,2873,1066,862,6.446870392294745,0.20653194444444445
2022-12-14,16,7,51,74,2550,922,850,6.371633630062793,0.13088513513513514
2022-12-15,18,2,107,127,2875,851,988,6.193282701017832,0.11732519685039369
2022-12-16,17,6,92,115,2361,765,1206,6.5189020281028816,0.07744086956521738
2022-12-17,9,5,47,61,1810,708,977,6.372345529699188,0.10200983606557378
2022-12-18,28,1,49,78,2173,715,1109,6.0954681003264,0.2522948717948718
2022-12-19,18,1,51,70,1700,497,584,6.35000591361734,0.20142
2022-12-20,22,2,71,95,2348,808,646,6.580941020928924,0.2110484210526316
2022-12-21,73,2,359,434,9176,2398,1180,5.602709613890501,0.20377603686635945
2022-12-22,13,6,48,67,4270,1712,1353,6.311314013723278,0.17108507462686567
2022-12-23,31,2,189,222,4526,1244,778,5.736338206414883,0.1265027027027027
2022-12-24,13,1,20,34,1676,681,1004,6.113287843812503,0.32741470588235294
2022-12-25,7,4,25,36,926,319,822,6.414611452894384,0.10990833333333333
2022-12-26,20,4,28,52,3080,1153,751,6.235626425329112,0.23705384615384617
2022-12-27,11,4,53,68,1597,544,960,6.642993095260594,0.09788088235294118
2022-12-28,18,2,35,55,3233,1232,1020,6.260581114424532,0.27316181818181823
2022-12-29,17,4,30,51,4161,1739,879,6.530503917931999,0.2597862745098039
2022-12-30,7,1,25,33,1714,666,539,6.327027808986091,0.17694242424242423
2022-12-31,8,1,21,30,1732,738,920,6.087944294553667,0.15777333333333335
